Town,County,Year,Total,Single,Multifamily,Duplex,TripQuad,QuintPlus
AUBURN,Androscoggin County,1980,40,40,0,0,0,0
AUBURN,Androscoggin County,1981,111,91,20,0,8,12
AUBURN,Androscoggin County,1982,44,20,24,0,0,24
AUBURN,Androscoggin County,1983,59,59,0,0,0,0
AUBURN,Androscoggin County,1984,87,45,42,6,0,36
AUBURN,Androscoggin County,1985,177,56,121,4,0,117
AUBURN,Androscoggin County,1986,204,88,116,8,3,105
AUBURN,Androscoggin County,1987,128,50,78,4,26,48
AUBURN,Androscoggin County,1988,264,78,186,6,0,180
AUBURN,Androscoggin County,1989,199,65,134,8,0,126
AUBURN,Androscoggin County,1990,33,27,6,6,0,0
AUBURN,Androscoggin County,1991,20,20,0,0,0,0
AUBURN,Androscoggin County,1992,45,19,26,0,0,26
AUBURN,Androscoggin County,1993,34,34,0,0,0,0
AUBURN,Androscoggin County,1994,40,38,2,2,0,0
AUBURN,Androscoggin County,1995,39,35,4,4,0,0
AUBURN,Androscoggin County,1996,21,21,0,0,0,0
AUBURN,Androscoggin County,1997,22,22,0,0,0,0
AUBURN,Androscoggin County,1998,22,22,0,0,0,0
AUBURN,Androscoggin County,1999,28,20,8,2,0,6
AUBURN,Androscoggin County,2000,35,26,9,0,9,0
AUBURN,Androscoggin County,2001,48,40,8,2,6,0
AUBURN,Androscoggin County,2002,55,40,15,12,3,0
AUBURN,Androscoggin County,2003,62,49,13,4,9,0
AUBURN,Androscoggin County,2004,71,69,2,2,0,0
AUBURN,Androscoggin County,2005,75,68,7,4,3,0
AUBURN,Androscoggin County,2006,65,59,6,6,0,0
AUBURN,Androscoggin County,2007,39,37,2,2,0,0
AUBURN,Androscoggin County,2008,34,24,10,10,0,0
AUBURN,Androscoggin County,2009,31,25,6,6,0,0
AUBURN,Androscoggin County,2010,35,25,10,10,0,0
AUBURN,Androscoggin County,2011,17,17,0,0,0,0
AUBURN,Androscoggin County,2012,18,16,2,2,0,0
AUBURN,Androscoggin County,2013,19,17,2,2,0,0
AUBURN,Androscoggin County,2014,23,23,0,0,0,0
AUBURN,Androscoggin County,2015,8,8,0,0,0,0
AUBURN,Androscoggin County,2016,33,25,8,2,0,6
AUBURN,Androscoggin County,2017,71,24,47,6,0,41
DURHAM TOWN,Androscoggin County,1980,26,26,0,0,0,0
DURHAM TOWN,Androscoggin County,1981,13,13,0,0,0,0
DURHAM TOWN,Androscoggin County,1982,23,21,2,2,0,0
DURHAM TOWN,Androscoggin County,1983,38,34,4,4,0,0
DURHAM TOWN,Androscoggin County,1984,79,73,6,6,0,0
DURHAM TOWN,Androscoggin County,1985,37,37,0,0,0,0
DURHAM TOWN,Androscoggin County,1986,54,52,2,2,0,0
DURHAM TOWN,Androscoggin County,1987,57,55,2,2,0,0
DURHAM TOWN,Androscoggin County,1988,57,53,4,4,0,0
DURHAM TOWN,Androscoggin County,1989,28,28,0,0,0,0
DURHAM TOWN,Androscoggin County,1990,15,15,0,0,0,0
DURHAM TOWN,Androscoggin County,1991,8,8,0,0,0,0
DURHAM TOWN,Androscoggin County,1992,20,20,0,0,0,0
DURHAM TOWN,Androscoggin County,1993,20,20,0,0,0,0
DURHAM TOWN,Androscoggin County,1994,33,33,0,0,0,0
DURHAM TOWN,Androscoggin County,1995,26,26,0,0,0,0
DURHAM TOWN,Androscoggin County,1996,63,63,0,0,0,0
DURHAM TOWN,Androscoggin County,1997,53,53,0,0,0,0
DURHAM TOWN,Androscoggin County,1998,58,58,0,0,0,0
DURHAM TOWN,Androscoggin County,1999,33,33,0,0,0,0
DURHAM TOWN,Androscoggin County,2000,31,31,0,0,0,0
DURHAM TOWN,Androscoggin County,2001,44,44,0,0,0,0
DURHAM TOWN,Androscoggin County,2002,49,49,0,0,0,0
DURHAM TOWN,Androscoggin County,2003,50,50,0,0,0,0
DURHAM TOWN,Androscoggin County,2004,52,52,0,0,0,0
DURHAM TOWN,Androscoggin County,2005,50,50,0,0,0,0
DURHAM TOWN,Androscoggin County,2006,29,29,0,0,0,0
DURHAM TOWN,Androscoggin County,2007,15,15,0,0,0,0
DURHAM TOWN,Androscoggin County,2008,14,14,0,0,0,0
DURHAM TOWN,Androscoggin County,2009,10,10,0,0,0,0
DURHAM TOWN,Androscoggin County,2010,14,14,0,0,0,0
DURHAM TOWN,Androscoggin County,2011,9,9,0,0,0,0
DURHAM TOWN,Androscoggin County,2012,9,9,0,0,0,0
DURHAM TOWN,Androscoggin County,2013,8,8,0,0,0,0
DURHAM TOWN,Androscoggin County,2014,10,10,0,0,0,0
DURHAM TOWN,Androscoggin County,2015,9,9,0,0,0,0
DURHAM TOWN,Androscoggin County,2016,10,10,0,0,0,0
DURHAM TOWN,Androscoggin County,2017,14,14,0,0,0,0
POLAND TOWN,Androscoggin County,1980,20,20,0,0,0,0
POLAND TOWN,Androscoggin County,1981,15,15,0,0,0,0
POLAND TOWN,Androscoggin County,1982,16,16,0,0,0,0
POLAND TOWN,Androscoggin County,1983,22,22,0,0,0,0
POLAND TOWN,Androscoggin County,1984,20,20,0,0,0,0
POLAND TOWN,Androscoggin County,1985,38,38,0,0,0,0
POLAND TOWN,Androscoggin County,1986,152,150,2,2,0,0
POLAND TOWN,Androscoggin County,1987,35,35,0,0,0,0
POLAND TOWN,Androscoggin County,1988,52,46,6,6,0,0
POLAND TOWN,Androscoggin County,1989,44,42,2,2,0,0
POLAND TOWN,Androscoggin County,1990,25,25,0,0,0,0
POLAND TOWN,Androscoggin County,1991,20,20,0,0,0,0
POLAND TOWN,Androscoggin County,1992,29,29,0,0,0,0
POLAND TOWN,Androscoggin County,1993,35,35,0,0,0,0
POLAND TOWN,Androscoggin County,1994,40,40,0,0,0,0
POLAND TOWN,Androscoggin County,1995,21,21,0,0,0,0
POLAND TOWN,Androscoggin County,1996,22,22,0,0,0,0
POLAND TOWN,Androscoggin County,1997,24,22,2,2,0,0
POLAND TOWN,Androscoggin County,1998,35,35,0,0,0,0
POLAND TOWN,Androscoggin County,1999,27,27,0,0,0,0
POLAND TOWN,Androscoggin County,2000,29,27,2,2,0,0
POLAND TOWN,Androscoggin County,2001,24,24,0,0,0,0
POLAND TOWN,Androscoggin County,2002,55,55,0,0,0,0
POLAND TOWN,Androscoggin County,2003,51,51,0,0,0,0
POLAND TOWN,Androscoggin County,2004,60,60,0,0,0,0
POLAND TOWN,Androscoggin County,2005,48,40,8,8,0,0
POLAND TOWN,Androscoggin County,2006,29,29,0,0,0,0
POLAND TOWN,Androscoggin County,2007,44,44,0,0,0,0
POLAND TOWN,Androscoggin County,2008,31,31,0,0,0,0
POLAND TOWN,Androscoggin County,2009,21,19,2,2,0,0
POLAND TOWN,Androscoggin County,2010,22,22,0,0,0,0
POLAND TOWN,Androscoggin County,2011,19,17,2,2,0,0
POLAND TOWN,Androscoggin County,2012,42,42,0,0,0,0
POLAND TOWN,Androscoggin County,2013,28,28,0,0,0,0
POLAND TOWN,Androscoggin County,2014,14,14,0,0,0,0
POLAND TOWN,Androscoggin County,2015,14,14,0,0,0,0
POLAND TOWN,Androscoggin County,2016,29,27,2,2,0,0
POLAND TOWN,Androscoggin County,2017,25,25,0,0,0,0
BALDWIN TOWN,Cumberland County,1980,2,2,0,0,0,0
BALDWIN TOWN,Cumberland County,1981,2,2,0,0,0,0
BALDWIN TOWN,Cumberland County,1982,2,2,0,0,0,0
BALDWIN TOWN,Cumberland County,1983,3,3,0,0,0,0
BALDWIN TOWN,Cumberland County,1984,3,3,0,0,0,0
BALDWIN TOWN,Cumberland County,1985,5,5,0,0,0,0
BALDWIN TOWN,Cumberland County,1986,6,6,0,0,0,0
BALDWIN TOWN,Cumberland County,1987,7,7,0,0,0,0
BALDWIN TOWN,Cumberland County,1988,6,6,0,0,0,0
BALDWIN TOWN,Cumberland County,1989,5,5,0,0,0,0
BALDWIN TOWN,Cumberland County,1990,4,4,0,0,0,0
BALDWIN TOWN,Cumberland County,1991,12,12,0,0,0,0
BALDWIN TOWN,Cumberland County,1992,5,5,0,0,0,0
BALDWIN TOWN,Cumberland County,1993,5,5,0,0,0,0
BALDWIN TOWN,Cumberland County,1994,9,9,0,0,0,0
BALDWIN TOWN,Cumberland County,1995,6,6,0,0,0,0
BALDWIN TOWN,Cumberland County,1996,7,7,0,0,0,0
BALDWIN TOWN,Cumberland County,1997,4,4,0,0,0,0
BALDWIN TOWN,Cumberland County,1998,7,7,0,0,0,0
BALDWIN TOWN,Cumberland County,1999,9,9,0,0,0,0
BALDWIN TOWN,Cumberland County,2000,7,7,0,0,0,0
BALDWIN TOWN,Cumberland County,2001,8,8,0,0,0,0
BALDWIN TOWN,Cumberland County,2002,13,13,0,0,0,0
BALDWIN TOWN,Cumberland County,2003,13,13,0,0,0,0
BALDWIN TOWN,Cumberland County,2004,20,20,0,0,0,0
BALDWIN TOWN,Cumberland County,2005,22,22,0,0,0,0
BALDWIN TOWN,Cumberland County,2006,10,10,0,0,0,0
BALDWIN TOWN,Cumberland County,2007,8,8,0,0,0,0
BALDWIN TOWN,Cumberland County,2008,3,3,0,0,0,0
BALDWIN TOWN,Cumberland County,2009,6,6,0,0,0,0
BALDWIN TOWN,Cumberland County,2010,9,9,0,0,0,0
BALDWIN TOWN,Cumberland County,2011,5,5,0,0,0,0
BALDWIN TOWN,Cumberland County,2012,5,5,0,0,0,0
BALDWIN TOWN,Cumberland County,2013,6,6,0,0,0,0
BALDWIN TOWN,Cumberland County,2014,3,3,0,0,0,0
BALDWIN TOWN,Cumberland County,2015,6,6,0,0,0,0
BALDWIN TOWN,Cumberland County,2016,8,8,0,0,0,0
BALDWIN TOWN,Cumberland County,2017,8,8,0,0,0,0
BRIDGTON TOWN,Cumberland County,1980,21,21,0,0,0,0
BRIDGTON TOWN,Cumberland County,1981,18,18,0,0,0,0
BRIDGTON TOWN,Cumberland County,1982,22,22,0,0,0,0
BRIDGTON TOWN,Cumberland County,1983,34,34,0,0,0,0
BRIDGTON TOWN,Cumberland County,1984,84,24,60,0,0,60
BRIDGTON TOWN,Cumberland County,1985,69,47,22,0,0,22
BRIDGTON TOWN,Cumberland County,1986,102,52,50,0,0,50
BRIDGTON TOWN,Cumberland County,1987,272,102,170,8,0,162
BRIDGTON TOWN,Cumberland County,1988,155,151,4,0,4,0
BRIDGTON TOWN,Cumberland County,1989,58,54,4,0,4,0
BRIDGTON TOWN,Cumberland County,1990,54,51,3,0,3,0
BRIDGTON TOWN,Cumberland County,1991,31,31,0,0,0,0
BRIDGTON TOWN,Cumberland County,1992,32,32,0,0,0,0
BRIDGTON TOWN,Cumberland County,1993,57,57,0,0,0,0
BRIDGTON TOWN,Cumberland County,1994,35,35,0,0,0,0
BRIDGTON TOWN,Cumberland County,1995,17,17,0,0,0,0
BRIDGTON TOWN,Cumberland County,1996,15,15,0,0,0,0
BRIDGTON TOWN,Cumberland County,1997,28,28,0,0,0,0
BRIDGTON TOWN,Cumberland County,1998,24,24,0,0,0,0
BRIDGTON TOWN,Cumberland County,1999,53,33,20,8,12,0
BRIDGTON TOWN,Cumberland County,2000,42,42,0,0,0,0
BRIDGTON TOWN,Cumberland County,2001,57,57,0,0,0,0
BRIDGTON TOWN,Cumberland County,2002,68,68,0,0,0,0
BRIDGTON TOWN,Cumberland County,2003,94,94,0,0,0,0
BRIDGTON TOWN,Cumberland County,2004,81,81,0,0,0,0
BRIDGTON TOWN,Cumberland County,2005,99,99,0,0,0,0
BRIDGTON TOWN,Cumberland County,2006,104,104,0,0,0,0
BRIDGTON TOWN,Cumberland County,2007,58,58,0,0,0,0
BRIDGTON TOWN,Cumberland County,2008,36,34,2,2,0,0
BRIDGTON TOWN,Cumberland County,2009,31,31,0,0,0,0
BRIDGTON TOWN,Cumberland County,2010,29,29,0,0,0,0
BRIDGTON TOWN,Cumberland County,2011,26,26,0,0,0,0
BRIDGTON TOWN,Cumberland County,2012,22,22,0,0,0,0
BRIDGTON TOWN,Cumberland County,2013,23,23,0,0,0,0
BRIDGTON TOWN,Cumberland County,2014,16,16,0,0,0,0
BRIDGTON TOWN,Cumberland County,2015,17,17,0,0,0,0
BRIDGTON TOWN,Cumberland County,2016,20,20,0,0,0,0
BRIDGTON TOWN,Cumberland County,2017,24,24,0,0,0,0
BRUNSWICK TOWN,Cumberland County,1980,39,39,0,0,0,0
BRUNSWICK TOWN,Cumberland County,1981,49,30,19,0,19,0
BRUNSWICK TOWN,Cumberland County,1982,48,45,3,0,3,0
BRUNSWICK TOWN,Cumberland County,1983,149,78,71,2,19,50
BRUNSWICK TOWN,Cumberland County,1984,252,160,92,4,0,88
BRUNSWICK TOWN,Cumberland County,1985,162,151,11,8,3,0
BRUNSWICK TOWN,Cumberland County,1986,273,183,90,0,27,63
BRUNSWICK TOWN,Cumberland County,1987,255,243,12,0,0,12
BRUNSWICK TOWN,Cumberland County,1988,138,126,12,0,0,12
BRUNSWICK TOWN,Cumberland County,1989,87,73,14,0,8,6
BRUNSWICK TOWN,Cumberland County,1990,64,64,0,0,0,0
BRUNSWICK TOWN,Cumberland County,1991,30,30,0,0,0,0
BRUNSWICK TOWN,Cumberland County,1992,100,58,42,26,9,7
BRUNSWICK TOWN,Cumberland County,1993,71,46,25,2,0,23
BRUNSWICK TOWN,Cumberland County,1994,32,32,0,0,0,0
BRUNSWICK TOWN,Cumberland County,1995,40,38,2,2,0,0
BRUNSWICK TOWN,Cumberland County,1996,50,46,4,0,4,0
BRUNSWICK TOWN,Cumberland County,1997,80,48,32,6,0,26
BRUNSWICK TOWN,Cumberland County,1998,63,59,4,4,0,0
BRUNSWICK TOWN,Cumberland County,1999,100,74,26,0,0,26
BRUNSWICK TOWN,Cumberland County,2000,86,86,0,0,0,0
BRUNSWICK TOWN,Cumberland County,2001,88,88,0,0,0,0
BRUNSWICK TOWN,Cumberland County,2002,111,97,14,4,0,10
BRUNSWICK TOWN,Cumberland County,2003,122,104,18,6,12,0
BRUNSWICK TOWN,Cumberland County,2004,96,77,19,2,17,0
BRUNSWICK TOWN,Cumberland County,2005,86,80,6,6,0,0
BRUNSWICK TOWN,Cumberland County,2006,121,73,48,0,0,48
BRUNSWICK TOWN,Cumberland County,2007,68,66,2,2,0,0
BRUNSWICK TOWN,Cumberland County,2008,21,21,0,0,0,0
BRUNSWICK TOWN,Cumberland County,2009,21,21,0,0,0,0
BRUNSWICK TOWN,Cumberland County,2010,26,26,0,0,0,0
BRUNSWICK TOWN,Cumberland County,2011,22,20,2,2,0,0
BRUNSWICK TOWN,Cumberland County,2012,26,26,0,0,0,0
BRUNSWICK TOWN,Cumberland County,2013,34,34,0,0,0,0
BRUNSWICK TOWN,Cumberland County,2014,34,34,0,0,0,0
BRUNSWICK TOWN,Cumberland County,2015,23,21,2,2,0,0
BRUNSWICK TOWN,Cumberland County,2016,59,35,24,0,0,24
BRUNSWICK TOWN,Cumberland County,2017,35,33,2,2,0,0
CAPE ELIZABETH TOWN,Cumberland County,1980,57,21,36,2,28,6
CAPE ELIZABETH TOWN,Cumberland County,1981,34,34,0,0,0,0
CAPE ELIZABETH TOWN,Cumberland County,1982,33,29,4,0,4,0
CAPE ELIZABETH TOWN,Cumberland County,1983,54,54,0,0,0,0
CAPE ELIZABETH TOWN,Cumberland County,1984,63,63,0,0,0,0
CAPE ELIZABETH TOWN,Cumberland County,1985,60,60,0,0,0,0
CAPE ELIZABETH TOWN,Cumberland County,1986,77,69,8,0,0,8
CAPE ELIZABETH TOWN,Cumberland County,1987,108,108,0,0,0,0
CAPE ELIZABETH TOWN,Cumberland County,1988,43,43,0,0,0,0
CAPE ELIZABETH TOWN,Cumberland County,1989,31,31,0,0,0,0
CAPE ELIZABETH TOWN,Cumberland County,1990,26,26,0,0,0,0
CAPE ELIZABETH TOWN,Cumberland County,1991,22,22,0,0,0,0
CAPE ELIZABETH TOWN,Cumberland County,1992,24,24,0,0,0,0
CAPE ELIZABETH TOWN,Cumberland County,1993,34,34,0,0,0,0
CAPE ELIZABETH TOWN,Cumberland County,1994,35,35,0,0,0,0
CAPE ELIZABETH TOWN,Cumberland County,1995,21,18,3,0,3,0
CAPE ELIZABETH TOWN,Cumberland County,1996,25,25,0,0,0,0
CAPE ELIZABETH TOWN,Cumberland County,1997,24,24,0,0,0,0
CAPE ELIZABETH TOWN,Cumberland County,1998,29,29,0,0,0,0
CAPE ELIZABETH TOWN,Cumberland County,1999,23,23,0,0,0,0
CAPE ELIZABETH TOWN,Cumberland County,2000,26,26,0,0,0,0
CAPE ELIZABETH TOWN,Cumberland County,2001,30,30,0,0,0,0
CAPE ELIZABETH TOWN,Cumberland County,2002,35,35,0,0,0,0
CAPE ELIZABETH TOWN,Cumberland County,2003,26,26,0,0,0,0
CAPE ELIZABETH TOWN,Cumberland County,2004,22,22,0,0,0,0
CAPE ELIZABETH TOWN,Cumberland County,2005,23,23,0,0,0,0
CAPE ELIZABETH TOWN,Cumberland County,2006,20,20,0,0,0,0
CAPE ELIZABETH TOWN,Cumberland County,2007,11,11,0,0,0,0
CAPE ELIZABETH TOWN,Cumberland County,2008,12,12,0,0,0,0
CAPE ELIZABETH TOWN,Cumberland County,2009,15,15,0,0,0,0
CAPE ELIZABETH TOWN,Cumberland County,2010,15,15,0,0,0,0
CAPE ELIZABETH TOWN,Cumberland County,2011,12,12,0,0,0,0
CAPE ELIZABETH TOWN,Cumberland County,2012,11,11,0,0,0,0
CAPE ELIZABETH TOWN,Cumberland County,2013,28,26,2,2,0,0
CAPE ELIZABETH TOWN,Cumberland County,2014,26,26,0,0,0,0
CAPE ELIZABETH TOWN,Cumberland County,2015,24,24,0,0,0,0
CAPE ELIZABETH TOWN,Cumberland County,2016,29,29,0,0,0,0
CAPE ELIZABETH TOWN,Cumberland County,2017,32,22,10,0,0,10
CASCO TOWN,Cumberland County,1980,13,13,0,0,0,0
CASCO TOWN,Cumberland County,1981,15,15,0,0,0,0
CASCO TOWN,Cumberland County,1982,8,8,0,0,0,0
CASCO TOWN,Cumberland County,1983,12,12,0,0,0,0
CASCO TOWN,Cumberland County,1984,18,16,2,2,0,0
CASCO TOWN,Cumberland County,1985,32,28,4,4,0,0
CASCO TOWN,Cumberland County,1986,57,44,13,6,7,0
CASCO TOWN,Cumberland County,1987,62,54,8,0,8,0
CASCO TOWN,Cumberland County,1988,31,29,2,2,0,0
CASCO TOWN,Cumberland County,1989,35,23,12,0,0,12
CASCO TOWN,Cumberland County,1990,26,26,0,0,0,0
CASCO TOWN,Cumberland County,1991,14,14,0,0,0,0
CASCO TOWN,Cumberland County,1992,21,21,0,0,0,0
CASCO TOWN,Cumberland County,1993,17,17,0,0,0,0
CASCO TOWN,Cumberland County,1994,21,21,0,0,0,0
CASCO TOWN,Cumberland County,1995,16,16,0,0,0,0
CASCO TOWN,Cumberland County,1996,13,13,0,0,0,0
CASCO TOWN,Cumberland County,1997,13,13,0,0,0,0
CASCO TOWN,Cumberland County,1998,26,26,0,0,0,0
CASCO TOWN,Cumberland County,1999,30,30,0,0,0,0
CASCO TOWN,Cumberland County,2000,26,26,0,0,0,0
CASCO TOWN,Cumberland County,2001,30,26,4,0,4,0
CASCO TOWN,Cumberland County,2002,28,25,3,0,3,0
CASCO TOWN,Cumberland County,2003,25,25,0,0,0,0
CASCO TOWN,Cumberland County,2004,54,54,0,0,0,0
CASCO TOWN,Cumberland County,2005,57,57,0,0,0,0
CASCO TOWN,Cumberland County,2006,49,49,0,0,0,0
CASCO TOWN,Cumberland County,2007,42,42,0,0,0,0
CASCO TOWN,Cumberland County,2008,11,11,0,0,0,0
CASCO TOWN,Cumberland County,2009,12,12,0,0,0,0
CASCO TOWN,Cumberland County,2010,13,13,0,0,0,0
CASCO TOWN,Cumberland County,2011,19,19,0,0,0,0
CASCO TOWN,Cumberland County,2012,21,21,0,0,0,0
CASCO TOWN,Cumberland County,2013,26,26,0,0,0,0
CASCO TOWN,Cumberland County,2014,24,24,0,0,0,0
CASCO TOWN,Cumberland County,2015,33,33,0,0,0,0
CASCO TOWN,Cumberland County,2016,19,19,0,0,0,0
CASCO TOWN,Cumberland County,2017,20,20,0,0,0,0
CHEBEAGUE ISLAND TOWN,Cumberland County,1980,0,0,0,0,0,0
CHEBEAGUE ISLAND TOWN,Cumberland County,1981,0,0,0,0,0,0
CHEBEAGUE ISLAND TOWN,Cumberland County,1982,0,0,0,0,0,0
CHEBEAGUE ISLAND TOWN,Cumberland County,1983,0,0,0,0,0,0
CHEBEAGUE ISLAND TOWN,Cumberland County,1984,0,0,0,0,0,0
CHEBEAGUE ISLAND TOWN,Cumberland County,1985,0,0,0,0,0,0
CHEBEAGUE ISLAND TOWN,Cumberland County,1986,0,0,0,0,0,0
CHEBEAGUE ISLAND TOWN,Cumberland County,1987,0,0,0,0,0,0
CHEBEAGUE ISLAND TOWN,Cumberland County,1988,0,0,0,0,0,0
CHEBEAGUE ISLAND TOWN,Cumberland County,1989,0,0,0,0,0,0
CHEBEAGUE ISLAND TOWN,Cumberland County,1990,0,0,0,0,0,0
CHEBEAGUE ISLAND TOWN,Cumberland County,1991,0,0,0,0,0,0
CHEBEAGUE ISLAND TOWN,Cumberland County,1992,0,0,0,0,0,0
CHEBEAGUE ISLAND TOWN,Cumberland County,1993,0,0,0,0,0,0
CHEBEAGUE ISLAND TOWN,Cumberland County,1994,0,0,0,0,0,0
CHEBEAGUE ISLAND TOWN,Cumberland County,1995,0,0,0,0,0,0
CHEBEAGUE ISLAND TOWN,Cumberland County,1996,0,0,0,0,0,0
CHEBEAGUE ISLAND TOWN,Cumberland County,1997,0,0,0,0,0,0
CHEBEAGUE ISLAND TOWN,Cumberland County,1998,0,0,0,0,0,0
CHEBEAGUE ISLAND TOWN,Cumberland County,1999,0,0,0,0,0,0
CHEBEAGUE ISLAND TOWN,Cumberland County,2000,0,0,0,0,0,0
CHEBEAGUE ISLAND TOWN,Cumberland County,2001,0,0,0,0,0,0
CHEBEAGUE ISLAND TOWN,Cumberland County,2002,0,0,0,0,0,0
CHEBEAGUE ISLAND TOWN,Cumberland County,2003,0,0,0,0,0,0
CHEBEAGUE ISLAND TOWN,Cumberland County,2004,0,0,0,0,0,0
CHEBEAGUE ISLAND TOWN,Cumberland County,2005,0,0,0,0,0,0
CHEBEAGUE ISLAND TOWN,Cumberland County,2006,0,0,0,0,0,0
CHEBEAGUE ISLAND TOWN,Cumberland County,2007,0,0,0,0,0,0
CHEBEAGUE ISLAND TOWN,Cumberland County,2008,2,2,0,0,0,0
CHEBEAGUE ISLAND TOWN,Cumberland County,2009,0,0,0,0,0,0
CHEBEAGUE ISLAND TOWN,Cumberland County,2010,1,1,0,0,0,0
CHEBEAGUE ISLAND TOWN,Cumberland County,2011,3,3,0,0,0,0
CHEBEAGUE ISLAND TOWN,Cumberland County,2012,1,1,0,0,0,0
CHEBEAGUE ISLAND TOWN,Cumberland County,2013,1,1,0,0,0,0
CHEBEAGUE ISLAND TOWN,Cumberland County,2014,4,4,0,0,0,0
CHEBEAGUE ISLAND TOWN,Cumberland County,2015,4,4,0,0,0,0
CHEBEAGUE ISLAND TOWN,Cumberland County,2016,0,0,0,0,0,0
CHEBEAGUE ISLAND TOWN,Cumberland County,2017,4,4,0,0,0,0
CUMBERLAND TOWN,Cumberland County,1980,32,23,9,6,3,0
CUMBERLAND TOWN,Cumberland County,1981,19,19,0,0,0,0
CUMBERLAND TOWN,Cumberland County,1982,18,18,0,0,0,0
CUMBERLAND TOWN,Cumberland County,1983,31,31,0,0,0,0
CUMBERLAND TOWN,Cumberland County,1984,45,45,0,0,0,0
CUMBERLAND TOWN,Cumberland County,1985,72,72,0,0,0,0
CUMBERLAND TOWN,Cumberland County,1986,160,160,0,0,0,0
CUMBERLAND TOWN,Cumberland County,1987,80,80,0,0,0,0
CUMBERLAND TOWN,Cumberland County,1988,42,42,0,0,0,0
CUMBERLAND TOWN,Cumberland County,1989,39,37,2,2,0,0
CUMBERLAND TOWN,Cumberland County,1990,34,34,0,0,0,0
CUMBERLAND TOWN,Cumberland County,1991,44,44,0,0,0,0
CUMBERLAND TOWN,Cumberland County,1992,70,70,0,0,0,0
CUMBERLAND TOWN,Cumberland County,1993,62,60,2,2,0,0
CUMBERLAND TOWN,Cumberland County,1994,53,51,2,2,0,0
CUMBERLAND TOWN,Cumberland County,1995,43,43,0,0,0,0
CUMBERLAND TOWN,Cumberland County,1996,44,44,0,0,0,0
CUMBERLAND TOWN,Cumberland County,1997,43,43,0,0,0,0
CUMBERLAND TOWN,Cumberland County,1998,65,65,0,0,0,0
CUMBERLAND TOWN,Cumberland County,1999,38,38,0,0,0,0
CUMBERLAND TOWN,Cumberland County,2000,86,86,0,0,0,0
CUMBERLAND TOWN,Cumberland County,2001,56,56,0,0,0,0
CUMBERLAND TOWN,Cumberland County,2002,40,40,0,0,0,0
CUMBERLAND TOWN,Cumberland County,2003,70,43,27,24,3,0
CUMBERLAND TOWN,Cumberland County,2004,67,53,14,14,0,0
CUMBERLAND TOWN,Cumberland County,2005,51,41,10,10,0,0
CUMBERLAND TOWN,Cumberland County,2006,39,27,12,2,10,0
CUMBERLAND TOWN,Cumberland County,2007,31,29,2,2,0,0
CUMBERLAND TOWN,Cumberland County,2008,22,22,0,0,0,0
CUMBERLAND TOWN,Cumberland County,2009,17,17,0,0,0,0
CUMBERLAND TOWN,Cumberland County,2010,15,15,0,0,0,0
CUMBERLAND TOWN,Cumberland County,2011,22,22,0,0,0,0
CUMBERLAND TOWN,Cumberland County,2012,25,25,0,0,0,0
CUMBERLAND TOWN,Cumberland County,2013,65,65,0,0,0,0
CUMBERLAND TOWN,Cumberland County,2014,59,59,0,0,0,0
CUMBERLAND TOWN,Cumberland County,2015,57,57,0,0,0,0
CUMBERLAND TOWN,Cumberland County,2016,156,60,96,0,0,96
CUMBERLAND TOWN,Cumberland County,2017,36,34,2,2,0,0
FALMOUTH TOWN,Cumberland County,1980,11,7,4,0,4,0
FALMOUTH TOWN,Cumberland County,1981,38,19,19,4,15,0
FALMOUTH TOWN,Cumberland County,1982,24,24,0,0,0,0
FALMOUTH TOWN,Cumberland County,1983,48,37,11,4,7,0
FALMOUTH TOWN,Cumberland County,1984,52,52,0,0,0,0
FALMOUTH TOWN,Cumberland County,1985,124,74,50,0,0,50
FALMOUTH TOWN,Cumberland County,1986,48,48,0,0,0,0
FALMOUTH TOWN,Cumberland County,1987,57,57,0,0,0,0
FALMOUTH TOWN,Cumberland County,1988,50,50,0,0,0,0
FALMOUTH TOWN,Cumberland County,1989,49,49,0,0,0,0
FALMOUTH TOWN,Cumberland County,1990,48,48,0,0,0,0
FALMOUTH TOWN,Cumberland County,1991,53,53,0,0,0,0
FALMOUTH TOWN,Cumberland County,1992,67,67,0,0,0,0
FALMOUTH TOWN,Cumberland County,1993,63,63,0,0,0,0
FALMOUTH TOWN,Cumberland County,1994,86,86,0,0,0,0
FALMOUTH TOWN,Cumberland County,1995,110,104,6,6,0,0
FALMOUTH TOWN,Cumberland County,1996,95,92,3,0,3,0
FALMOUTH TOWN,Cumberland County,1997,84,84,0,0,0,0
FALMOUTH TOWN,Cumberland County,1998,106,102,4,4,0,0
FALMOUTH TOWN,Cumberland County,1999,113,103,10,10,0,0
FALMOUTH TOWN,Cumberland County,2000,89,89,0,0,0,0
FALMOUTH TOWN,Cumberland County,2001,55,55,0,0,0,0
FALMOUTH TOWN,Cumberland County,2002,66,66,0,0,0,0
FALMOUTH TOWN,Cumberland County,2003,60,60,0,0,0,0
FALMOUTH TOWN,Cumberland County,2004,44,44,0,0,0,0
FALMOUTH TOWN,Cumberland County,2005,52,52,0,0,0,0
FALMOUTH TOWN,Cumberland County,2006,66,66,0,0,0,0
FALMOUTH TOWN,Cumberland County,2007,62,62,0,0,0,0
FALMOUTH TOWN,Cumberland County,2008,30,30,0,0,0,0
FALMOUTH TOWN,Cumberland County,2009,50,50,0,0,0,0
FALMOUTH TOWN,Cumberland County,2010,40,40,0,0,0,0
FALMOUTH TOWN,Cumberland County,2011,42,42,0,0,0,0
FALMOUTH TOWN,Cumberland County,2012,37,37,0,0,0,0
FALMOUTH TOWN,Cumberland County,2013,98,62,36,0,0,36
FALMOUTH TOWN,Cumberland County,2014,101,41,60,0,0,60
FALMOUTH TOWN,Cumberland County,2015,63,63,0,0,0,0
FALMOUTH TOWN,Cumberland County,2016,64,64,0,0,0,0
FALMOUTH TOWN,Cumberland County,2017,63,61,2,2,0,0
FREEPORT TOWN,Cumberland County,1980,47,21,26,0,26,0
FREEPORT TOWN,Cumberland County,1981,17,17,0,0,0,0
FREEPORT TOWN,Cumberland County,1982,26,26,0,0,0,0
FREEPORT TOWN,Cumberland County,1983,83,41,42,0,8,34
FREEPORT TOWN,Cumberland County,1984,77,77,0,0,0,0
FREEPORT TOWN,Cumberland County,1985,70,54,16,0,16,0
FREEPORT TOWN,Cumberland County,1986,66,58,8,8,0,0
FREEPORT TOWN,Cumberland County,1987,84,68,16,10,0,6
FREEPORT TOWN,Cumberland County,1988,99,45,54,0,0,54
FREEPORT TOWN,Cumberland County,1989,41,41,0,0,0,0
FREEPORT TOWN,Cumberland County,1990,29,29,0,0,0,0
FREEPORT TOWN,Cumberland County,1991,25,21,4,4,0,0
FREEPORT TOWN,Cumberland County,1992,35,35,0,0,0,0
FREEPORT TOWN,Cumberland County,1993,43,43,0,0,0,0
FREEPORT TOWN,Cumberland County,1994,45,45,0,0,0,0
FREEPORT TOWN,Cumberland County,1995,30,30,0,0,0,0
FREEPORT TOWN,Cumberland County,1996,75,45,30,0,0,30
FREEPORT TOWN,Cumberland County,1997,49,49,0,0,0,0
FREEPORT TOWN,Cumberland County,1998,40,40,0,0,0,0
FREEPORT TOWN,Cumberland County,1999,51,49,2,2,0,0
FREEPORT TOWN,Cumberland County,2000,45,45,0,0,0,0
FREEPORT TOWN,Cumberland County,2001,48,44,4,4,0,0
FREEPORT TOWN,Cumberland County,2002,41,37,4,4,0,0
FREEPORT TOWN,Cumberland County,2003,57,57,0,0,0,0
FREEPORT TOWN,Cumberland County,2004,50,48,2,2,0,0
FREEPORT TOWN,Cumberland County,2005,96,82,14,14,0,0
FREEPORT TOWN,Cumberland County,2006,63,58,5,2,3,0
FREEPORT TOWN,Cumberland County,2007,26,24,2,2,0,0
FREEPORT TOWN,Cumberland County,2008,24,21,3,0,3,0
FREEPORT TOWN,Cumberland County,2009,20,20,0,0,0,0
FREEPORT TOWN,Cumberland County,2010,26,22,4,0,4,0
FREEPORT TOWN,Cumberland County,2011,50,25,25,0,0,25
FREEPORT TOWN,Cumberland County,2012,37,34,3,0,3,0
FREEPORT TOWN,Cumberland County,2013,50,50,0,0,0,0
FREEPORT TOWN,Cumberland County,2014,40,38,2,2,0,0
FREEPORT TOWN,Cumberland County,2015,58,53,5,2,3,0
FREEPORT TOWN,Cumberland County,2016,46,44,2,2,0,0
FREEPORT TOWN,Cumberland County,2017,52,46,6,6,0,0
FRYE ISLAND TOWN,Cumberland County,1980,0,0,0,0,0,0
FRYE ISLAND TOWN,Cumberland County,1981,0,0,0,0,0,0
FRYE ISLAND TOWN,Cumberland County,1982,0,0,0,0,0,0
FRYE ISLAND TOWN,Cumberland County,1983,0,0,0,0,0,0
FRYE ISLAND TOWN,Cumberland County,1984,0,0,0,0,0,0
FRYE ISLAND TOWN,Cumberland County,1985,0,0,0,0,0,0
FRYE ISLAND TOWN,Cumberland County,1986,0,0,0,0,0,0
FRYE ISLAND TOWN,Cumberland County,1987,0,0,0,0,0,0
FRYE ISLAND TOWN,Cumberland County,1988,0,0,0,0,0,0
FRYE ISLAND TOWN,Cumberland County,1989,0,0,0,0,0,0
FRYE ISLAND TOWN,Cumberland County,1990,0,0,0,0,0,0
FRYE ISLAND TOWN,Cumberland County,1991,0,0,0,0,0,0
FRYE ISLAND TOWN,Cumberland County,1992,0,0,0,0,0,0
FRYE ISLAND TOWN,Cumberland County,1993,0,0,0,0,0,0
FRYE ISLAND TOWN,Cumberland County,1994,0,0,0,0,0,0
FRYE ISLAND TOWN,Cumberland County,1995,0,0,0,0,0,0
FRYE ISLAND TOWN,Cumberland County,1996,0,0,0,0,0,0
FRYE ISLAND TOWN,Cumberland County,1997,0,0,0,0,0,0
FRYE ISLAND TOWN,Cumberland County,1998,0,0,0,0,0,0
FRYE ISLAND TOWN,Cumberland County,1999,0,0,0,0,0,0
FRYE ISLAND TOWN,Cumberland County,2000,0,0,0,0,0,0
FRYE ISLAND TOWN,Cumberland County,2001,0,0,0,0,0,0
FRYE ISLAND TOWN,Cumberland County,2002,0,0,0,0,0,0
FRYE ISLAND TOWN,Cumberland County,2003,0,0,0,0,0,0
FRYE ISLAND TOWN,Cumberland County,2004,14,14,0,0,0,0
FRYE ISLAND TOWN,Cumberland County,2005,0,0,0,0,0,0
FRYE ISLAND TOWN,Cumberland County,2006,0,0,0,0,0,0
FRYE ISLAND TOWN,Cumberland County,2007,0,0,0,0,0,0
FRYE ISLAND TOWN,Cumberland County,2008,0,0,0,0,0,0
FRYE ISLAND TOWN,Cumberland County,2009,0,0,0,0,0,0
FRYE ISLAND TOWN,Cumberland County,2010,0,0,0,0,0,0
FRYE ISLAND TOWN,Cumberland County,2011,0,0,0,0,0,0
FRYE ISLAND TOWN,Cumberland County,2012,0,0,0,0,0,0
FRYE ISLAND TOWN,Cumberland County,2013,0,0,0,0,0,0
FRYE ISLAND TOWN,Cumberland County,2014,0,0,0,0,0,0
FRYE ISLAND TOWN,Cumberland County,2015,5,5,0,0,0,0
FRYE ISLAND TOWN,Cumberland County,2016,4,4,0,0,0,0
FRYE ISLAND TOWN,Cumberland County,2017,4,4,0,0,0,0
GORHAM TOWN,Cumberland County,1980,42,42,0,0,0,0
GORHAM TOWN,Cumberland County,1981,33,31,2,2,0,0
GORHAM TOWN,Cumberland County,1982,54,54,0,0,0,0
GORHAM TOWN,Cumberland County,1983,107,83,24,2,0,22
GORHAM TOWN,Cumberland County,1984,116,102,14,14,0,0
GORHAM TOWN,Cumberland County,1985,114,84,30,10,4,16
GORHAM TOWN,Cumberland County,1986,122,112,10,10,0,0
GORHAM TOWN,Cumberland County,1987,97,91,6,6,0,0
GORHAM TOWN,Cumberland County,1988,81,77,4,4,0,0
GORHAM TOWN,Cumberland County,1989,97,75,22,12,0,10
GORHAM TOWN,Cumberland County,1990,63,59,4,4,0,0
GORHAM TOWN,Cumberland County,1991,88,86,2,2,0,0
GORHAM TOWN,Cumberland County,1992,93,93,0,0,0,0
GORHAM TOWN,Cumberland County,1993,68,66,2,2,0,0
GORHAM TOWN,Cumberland County,1994,102,102,0,0,0,0
GORHAM TOWN,Cumberland County,1995,53,53,0,0,0,0
GORHAM TOWN,Cumberland County,1996,88,86,2,2,0,0
GORHAM TOWN,Cumberland County,1997,82,82,0,0,0,0
GORHAM TOWN,Cumberland County,1998,114,98,16,4,12,0
GORHAM TOWN,Cumberland County,1999,101,101,0,0,0,0
GORHAM TOWN,Cumberland County,2000,105,105,0,0,0,0
GORHAM TOWN,Cumberland County,2001,141,139,2,2,0,0
GORHAM TOWN,Cumberland County,2002,195,195,0,0,0,0
GORHAM TOWN,Cumberland County,2003,89,89,0,0,0,0
GORHAM TOWN,Cumberland County,2004,104,100,4,4,0,0
GORHAM TOWN,Cumberland County,2005,128,126,2,2,0,0
GORHAM TOWN,Cumberland County,2006,69,69,0,0,0,0
GORHAM TOWN,Cumberland County,2007,68,68,0,0,0,0
GORHAM TOWN,Cumberland County,2008,36,30,6,2,4,0
GORHAM TOWN,Cumberland County,2009,40,40,0,0,0,0
GORHAM TOWN,Cumberland County,2010,53,53,0,0,0,0
GORHAM TOWN,Cumberland County,2011,57,57,0,0,0,0
GORHAM TOWN,Cumberland County,2012,69,69,0,0,0,0
GORHAM TOWN,Cumberland County,2013,67,67,0,0,0,0
GORHAM TOWN,Cumberland County,2014,76,76,0,0,0,0
GORHAM TOWN,Cumberland County,2015,89,89,0,0,0,0
GORHAM TOWN,Cumberland County,2016,78,78,0,0,0,0
GORHAM TOWN,Cumberland County,2017,123,123,0,0,0,0
GRAY TOWN,Cumberland County,1980,32,32,0,0,0,0
GRAY TOWN,Cumberland County,1981,23,23,0,0,0,0
GRAY TOWN,Cumberland County,1982,52,44,8,0,8,0
GRAY TOWN,Cumberland County,1983,68,61,7,0,7,0
GRAY TOWN,Cumberland County,1984,94,82,12,0,12,0
GRAY TOWN,Cumberland County,1985,98,95,3,0,3,0
GRAY TOWN,Cumberland County,1986,120,111,9,0,9,0
GRAY TOWN,Cumberland County,1987,112,106,6,0,6,0
GRAY TOWN,Cumberland County,1988,87,87,0,0,0,0
GRAY TOWN,Cumberland County,1989,70,67,3,0,3,0
GRAY TOWN,Cumberland County,1990,45,45,0,0,0,0
GRAY TOWN,Cumberland County,1991,43,35,8,8,0,0
GRAY TOWN,Cumberland County,1992,50,48,2,2,0,0
GRAY TOWN,Cumberland County,1993,51,45,6,6,0,0
GRAY TOWN,Cumberland County,1994,73,57,16,16,0,0
GRAY TOWN,Cumberland County,1995,56,46,10,10,0,0
GRAY TOWN,Cumberland County,1996,52,52,0,0,0,0
GRAY TOWN,Cumberland County,1997,57,57,0,0,0,0
GRAY TOWN,Cumberland County,1998,60,60,0,0,0,0
GRAY TOWN,Cumberland County,1999,62,62,0,0,0,0
GRAY TOWN,Cumberland County,2000,77,69,8,0,8,0
GRAY TOWN,Cumberland County,2001,79,73,6,6,0,0
GRAY TOWN,Cumberland County,2002,75,67,8,8,0,0
GRAY TOWN,Cumberland County,2003,72,72,0,0,0,0
GRAY TOWN,Cumberland County,2004,84,84,0,0,0,0
GRAY TOWN,Cumberland County,2005,79,65,14,14,0,0
GRAY TOWN,Cumberland County,2006,74,62,12,4,8,0
GRAY TOWN,Cumberland County,2007,31,31,0,0,0,0
GRAY TOWN,Cumberland County,2008,33,27,6,6,0,0
GRAY TOWN,Cumberland County,2009,27,25,2,2,0,0
GRAY TOWN,Cumberland County,2010,23,23,0,0,0,0
GRAY TOWN,Cumberland County,2011,20,18,2,2,0,0
GRAY TOWN,Cumberland County,2012,21,17,4,4,0,0
GRAY TOWN,Cumberland County,2013,27,21,6,6,0,0
GRAY TOWN,Cumberland County,2014,35,27,8,8,0,0
GRAY TOWN,Cumberland County,2015,40,34,6,6,0,0
GRAY TOWN,Cumberland County,2016,65,41,24,24,0,0
GRAY TOWN,Cumberland County,2017,48,38,10,10,0,0
HARPSWELL TOWN,Cumberland County,1980,0,0,0,0,0,0
HARPSWELL TOWN,Cumberland County,1981,0,0,0,0,0,0
HARPSWELL TOWN,Cumberland County,1982,0,0,0,0,0,0
HARPSWELL TOWN,Cumberland County,1983,0,0,0,0,0,0
HARPSWELL TOWN,Cumberland County,1984,0,0,0,0,0,0
HARPSWELL TOWN,Cumberland County,1985,36,36,0,0,0,0
HARPSWELL TOWN,Cumberland County,1986,46,46,0,0,0,0
HARPSWELL TOWN,Cumberland County,1987,54,54,0,0,0,0
HARPSWELL TOWN,Cumberland County,1988,51,51,0,0,0,0
HARPSWELL TOWN,Cumberland County,1989,42,42,0,0,0,0
HARPSWELL TOWN,Cumberland County,1990,33,33,0,0,0,0
HARPSWELL TOWN,Cumberland County,1991,28,28,0,0,0,0
HARPSWELL TOWN,Cumberland County,1992,29,29,0,0,0,0
HARPSWELL TOWN,Cumberland County,1993,27,27,0,0,0,0
HARPSWELL TOWN,Cumberland County,1994,0,0,0,0,0,0
HARPSWELL TOWN,Cumberland County,1995,0,0,0,0,0,0
HARPSWELL TOWN,Cumberland County,1996,0,0,0,0,0,0
HARPSWELL TOWN,Cumberland County,1997,0,0,0,0,0,0
HARPSWELL TOWN,Cumberland County,1998,0,0,0,0,0,0
HARPSWELL TOWN,Cumberland County,1999,0,0,0,0,0,0
HARPSWELL TOWN,Cumberland County,2000,0,0,0,0,0,0
HARPSWELL TOWN,Cumberland County,2001,0,0,0,0,0,0
HARPSWELL TOWN,Cumberland County,2002,76,76,0,0,0,0
HARPSWELL TOWN,Cumberland County,2003,60,60,0,0,0,0
HARPSWELL TOWN,Cumberland County,2004,12,12,0,0,0,0
HARPSWELL TOWN,Cumberland County,2005,31,31,0,0,0,0
HARPSWELL TOWN,Cumberland County,2006,31,31,0,0,0,0
HARPSWELL TOWN,Cumberland County,2007,43,43,0,0,0,0
HARPSWELL TOWN,Cumberland County,2008,28,28,0,0,0,0
HARPSWELL TOWN,Cumberland County,2009,18,18,0,0,0,0
HARPSWELL TOWN,Cumberland County,2010,20,20,0,0,0,0
HARPSWELL TOWN,Cumberland County,2011,15,15,0,0,0,0
HARPSWELL TOWN,Cumberland County,2012,14,14,0,0,0,0
HARPSWELL TOWN,Cumberland County,2013,33,33,0,0,0,0
HARPSWELL TOWN,Cumberland County,2014,25,25,0,0,0,0
HARPSWELL TOWN,Cumberland County,2015,21,21,0,0,0,0
HARPSWELL TOWN,Cumberland County,2016,32,32,0,0,0,0
HARPSWELL TOWN,Cumberland County,2017,41,41,0,0,0,0
HARRISON TOWN,Cumberland County,1980,28,26,2,2,0,0
HARRISON TOWN,Cumberland County,1981,29,29,0,0,0,0
HARRISON TOWN,Cumberland County,1982,29,29,0,0,0,0
HARRISON TOWN,Cumberland County,1983,10,10,0,0,0,0
HARRISON TOWN,Cumberland County,1984,34,34,0,0,0,0
HARRISON TOWN,Cumberland County,1985,23,23,0,0,0,0
HARRISON TOWN,Cumberland County,1986,34,34,0,0,0,0
HARRISON TOWN,Cumberland County,1987,65,65,0,0,0,0
HARRISON TOWN,Cumberland County,1988,51,47,4,0,4,0
HARRISON TOWN,Cumberland County,1989,42,42,0,0,0,0
HARRISON TOWN,Cumberland County,1990,27,27,0,0,0,0
HARRISON TOWN,Cumberland County,1991,22,22,0,0,0,0
HARRISON TOWN,Cumberland County,1992,23,23,0,0,0,0
HARRISON TOWN,Cumberland County,1993,17,17,0,0,0,0
HARRISON TOWN,Cumberland County,1994,15,15,0,0,0,0
HARRISON TOWN,Cumberland County,1995,9,9,0,0,0,0
HARRISON TOWN,Cumberland County,1996,12,12,0,0,0,0
HARRISON TOWN,Cumberland County,1997,17,17,0,0,0,0
HARRISON TOWN,Cumberland County,1998,17,17,0,0,0,0
HARRISON TOWN,Cumberland County,1999,18,18,0,0,0,0
HARRISON TOWN,Cumberland County,2000,16,16,0,0,0,0
HARRISON TOWN,Cumberland County,2001,15,15,0,0,0,0
HARRISON TOWN,Cumberland County,2002,17,17,0,0,0,0
HARRISON TOWN,Cumberland County,2003,16,16,0,0,0,0
HARRISON TOWN,Cumberland County,2004,15,15,0,0,0,0
HARRISON TOWN,Cumberland County,2005,33,33,0,0,0,0
HARRISON TOWN,Cumberland County,2006,26,26,0,0,0,0
HARRISON TOWN,Cumberland County,2007,22,22,0,0,0,0
HARRISON TOWN,Cumberland County,2008,13,13,0,0,0,0
HARRISON TOWN,Cumberland County,2009,5,5,0,0,0,0
HARRISON TOWN,Cumberland County,2010,11,11,0,0,0,0
HARRISON TOWN,Cumberland County,2011,7,7,0,0,0,0
HARRISON TOWN,Cumberland County,2012,11,11,0,0,0,0
HARRISON TOWN,Cumberland County,2013,8,8,0,0,0,0
HARRISON TOWN,Cumberland County,2014,5,5,0,0,0,0
HARRISON TOWN,Cumberland County,2015,4,4,0,0,0,0
HARRISON TOWN,Cumberland County,2016,8,8,0,0,0,0
HARRISON TOWN,Cumberland County,2017,12,12,0,0,0,0
LONG ISLAND TOWN,Cumberland County,1980,0,0,0,0,0,0
LONG ISLAND TOWN,Cumberland County,1981,0,0,0,0,0,0
LONG ISLAND TOWN,Cumberland County,1982,0,0,0,0,0,0
LONG ISLAND TOWN,Cumberland County,1983,0,0,0,0,0,0
LONG ISLAND TOWN,Cumberland County,1984,0,0,0,0,0,0
LONG ISLAND TOWN,Cumberland County,1985,0,0,0,0,0,0
LONG ISLAND TOWN,Cumberland County,1986,0,0,0,0,0,0
LONG ISLAND TOWN,Cumberland County,1987,0,0,0,0,0,0
LONG ISLAND TOWN,Cumberland County,1988,0,0,0,0,0,0
LONG ISLAND TOWN,Cumberland County,1989,0,0,0,0,0,0
LONG ISLAND TOWN,Cumberland County,1990,0,0,0,0,0,0
LONG ISLAND TOWN,Cumberland County,1991,0,0,0,0,0,0
LONG ISLAND TOWN,Cumberland County,1992,0,0,0,0,0,0
LONG ISLAND TOWN,Cumberland County,1993,0,0,0,0,0,0
LONG ISLAND TOWN,Cumberland County,1994,2,2,0,0,0,0
LONG ISLAND TOWN,Cumberland County,1995,2,2,0,0,0,0
LONG ISLAND TOWN,Cumberland County,1996,2,2,0,0,0,0
LONG ISLAND TOWN,Cumberland County,1997,0,0,0,0,0,0
LONG ISLAND TOWN,Cumberland County,1998,0,0,0,0,0,0
LONG ISLAND TOWN,Cumberland County,1999,6,6,0,0,0,0
LONG ISLAND TOWN,Cumberland County,2000,2,2,0,0,0,0
LONG ISLAND TOWN,Cumberland County,2001,0,0,0,0,0,0
LONG ISLAND TOWN,Cumberland County,2002,0,0,0,0,0,0
LONG ISLAND TOWN,Cumberland County,2003,0,0,0,0,0,0
LONG ISLAND TOWN,Cumberland County,2004,4,4,0,0,0,0
LONG ISLAND TOWN,Cumberland County,2005,4,4,0,0,0,0
LONG ISLAND TOWN,Cumberland County,2006,2,2,0,0,0,0
LONG ISLAND TOWN,Cumberland County,2007,3,3,0,0,0,0
LONG ISLAND TOWN,Cumberland County,2008,1,1,0,0,0,0
LONG ISLAND TOWN,Cumberland County,2009,5,5,0,0,0,0
LONG ISLAND TOWN,Cumberland County,2010,2,2,0,0,0,0
LONG ISLAND TOWN,Cumberland County,2011,4,4,0,0,0,0
LONG ISLAND TOWN,Cumberland County,2012,4,4,0,0,0,0
LONG ISLAND TOWN,Cumberland County,2013,1,1,0,0,0,0
LONG ISLAND TOWN,Cumberland County,2014,2,2,0,0,0,0
LONG ISLAND TOWN,Cumberland County,2015,2,2,0,0,0,0
LONG ISLAND TOWN,Cumberland County,2016,3,3,0,0,0,0
LONG ISLAND TOWN,Cumberland County,2017,3,1,2,2,0,0
NAPLES TOWN,Cumberland County,1980,7,7,0,0,0,0
NAPLES TOWN,Cumberland County,1981,22,18,4,4,0,0
NAPLES TOWN,Cumberland County,1982,13,13,0,0,0,0
NAPLES TOWN,Cumberland County,1983,21,21,0,0,0,0
NAPLES TOWN,Cumberland County,1984,21,21,0,0,0,0
NAPLES TOWN,Cumberland County,1985,38,34,4,4,0,0
NAPLES TOWN,Cumberland County,1986,47,47,0,0,0,0
NAPLES TOWN,Cumberland County,1987,104,79,25,2,0,23
NAPLES TOWN,Cumberland County,1988,116,74,42,0,4,38
NAPLES TOWN,Cumberland County,1989,77,77,0,0,0,0
NAPLES TOWN,Cumberland County,1990,31,31,0,0,0,0
NAPLES TOWN,Cumberland County,1991,38,36,2,2,0,0
NAPLES TOWN,Cumberland County,1992,29,29,0,0,0,0
NAPLES TOWN,Cumberland County,1993,26,26,0,0,0,0
NAPLES TOWN,Cumberland County,1994,24,22,2,2,0,0
NAPLES TOWN,Cumberland County,1995,18,18,0,0,0,0
NAPLES TOWN,Cumberland County,1996,15,15,0,0,0,0
NAPLES TOWN,Cumberland County,1997,16,16,0,0,0,0
NAPLES TOWN,Cumberland County,1998,28,28,0,0,0,0
NAPLES TOWN,Cumberland County,1999,28,28,0,0,0,0
NAPLES TOWN,Cumberland County,2000,36,36,0,0,0,0
NAPLES TOWN,Cumberland County,2001,48,48,0,0,0,0
NAPLES TOWN,Cumberland County,2002,53,53,0,0,0,0
NAPLES TOWN,Cumberland County,2003,75,75,0,0,0,0
NAPLES TOWN,Cumberland County,2004,95,95,0,0,0,0
NAPLES TOWN,Cumberland County,2005,64,64,0,0,0,0
NAPLES TOWN,Cumberland County,2006,46,46,0,0,0,0
NAPLES TOWN,Cumberland County,2007,42,42,0,0,0,0
NAPLES TOWN,Cumberland County,2008,35,35,0,0,0,0
NAPLES TOWN,Cumberland County,2009,32,32,0,0,0,0
NAPLES TOWN,Cumberland County,2010,14,14,0,0,0,0
NAPLES TOWN,Cumberland County,2011,11,11,0,0,0,0
NAPLES TOWN,Cumberland County,2012,13,13,0,0,0,0
NAPLES TOWN,Cumberland County,2013,17,17,0,0,0,0
NAPLES TOWN,Cumberland County,2014,14,14,0,0,0,0
NAPLES TOWN,Cumberland County,2015,13,13,0,0,0,0
NAPLES TOWN,Cumberland County,2016,15,15,0,0,0,0
NAPLES TOWN,Cumberland County,2017,14,14,0,0,0,0
NEW GLOUCESTER TOWN,Cumberland County,1980,17,17,0,0,0,0
NEW GLOUCESTER TOWN,Cumberland County,1981,17,17,0,0,0,0
NEW GLOUCESTER TOWN,Cumberland County,1982,17,17,0,0,0,0
NEW GLOUCESTER TOWN,Cumberland County,1983,23,23,0,0,0,0
NEW GLOUCESTER TOWN,Cumberland County,1984,32,28,4,0,4,0
NEW GLOUCESTER TOWN,Cumberland County,1985,43,37,6,2,4,0
NEW GLOUCESTER TOWN,Cumberland County,1986,51,47,4,4,0,0
NEW GLOUCESTER TOWN,Cumberland County,1987,67,59,8,8,0,0
NEW GLOUCESTER TOWN,Cumberland County,1988,5,5,0,0,0,0
NEW GLOUCESTER TOWN,Cumberland County,1989,39,39,0,0,0,0
NEW GLOUCESTER TOWN,Cumberland County,1990,31,27,4,4,0,0
NEW GLOUCESTER TOWN,Cumberland County,1991,30,28,2,2,0,0
NEW GLOUCESTER TOWN,Cumberland County,1992,34,32,2,2,0,0
NEW GLOUCESTER TOWN,Cumberland County,1993,41,41,0,0,0,0
NEW GLOUCESTER TOWN,Cumberland County,1994,39,39,0,0,0,0
NEW GLOUCESTER TOWN,Cumberland County,1995,34,32,2,2,0,0
NEW GLOUCESTER TOWN,Cumberland County,1996,37,37,0,0,0,0
NEW GLOUCESTER TOWN,Cumberland County,1997,36,32,4,4,0,0
NEW GLOUCESTER TOWN,Cumberland County,1998,60,58,2,2,0,0
NEW GLOUCESTER TOWN,Cumberland County,1999,47,47,0,0,0,0
NEW GLOUCESTER TOWN,Cumberland County,2000,48,48,0,0,0,0
NEW GLOUCESTER TOWN,Cumberland County,2001,48,48,0,0,0,0
NEW GLOUCESTER TOWN,Cumberland County,2002,63,63,0,0,0,0
NEW GLOUCESTER TOWN,Cumberland County,2003,56,46,10,10,0,0
NEW GLOUCESTER TOWN,Cumberland County,2004,47,43,4,4,0,0
NEW GLOUCESTER TOWN,Cumberland County,2005,66,64,2,2,0,0
NEW GLOUCESTER TOWN,Cumberland County,2006,30,30,0,0,0,0
NEW GLOUCESTER TOWN,Cumberland County,2007,39,39,0,0,0,0
NEW GLOUCESTER TOWN,Cumberland County,2008,23,23,0,0,0,0
NEW GLOUCESTER TOWN,Cumberland County,2009,18,18,0,0,0,0
NEW GLOUCESTER TOWN,Cumberland County,2010,8,8,0,0,0,0
NEW GLOUCESTER TOWN,Cumberland County,2011,11,11,0,0,0,0
NEW GLOUCESTER TOWN,Cumberland County,2012,10,10,0,0,0,0
NEW GLOUCESTER TOWN,Cumberland County,2013,15,15,0,0,0,0
NEW GLOUCESTER TOWN,Cumberland County,2014,13,13,0,0,0,0
NEW GLOUCESTER TOWN,Cumberland County,2015,18,18,0,0,0,0
NEW GLOUCESTER TOWN,Cumberland County,2016,22,22,0,0,0,0
NEW GLOUCESTER TOWN,Cumberland County,2017,34,34,0,0,0,0
NORTH YARMOUTH TOWN,Cumberland County,1980,18,18,0,0,0,0
NORTH YARMOUTH TOWN,Cumberland County,1981,14,14,0,0,0,0
NORTH YARMOUTH TOWN,Cumberland County,1982,12,12,0,0,0,0
NORTH YARMOUTH TOWN,Cumberland County,1983,23,21,2,2,0,0
NORTH YARMOUTH TOWN,Cumberland County,1984,35,35,0,0,0,0
NORTH YARMOUTH TOWN,Cumberland County,1985,32,32,0,0,0,0
NORTH YARMOUTH TOWN,Cumberland County,1986,35,35,0,0,0,0
NORTH YARMOUTH TOWN,Cumberland County,1987,38,38,0,0,0,0
NORTH YARMOUTH TOWN,Cumberland County,1988,29,29,0,0,0,0
NORTH YARMOUTH TOWN,Cumberland County,1989,33,33,0,0,0,0
NORTH YARMOUTH TOWN,Cumberland County,1990,26,20,6,6,0,0
NORTH YARMOUTH TOWN,Cumberland County,1991,24,24,0,0,0,0
NORTH YARMOUTH TOWN,Cumberland County,1992,21,21,0,0,0,0
NORTH YARMOUTH TOWN,Cumberland County,1993,31,31,0,0,0,0
NORTH YARMOUTH TOWN,Cumberland County,1994,33,33,0,0,0,0
NORTH YARMOUTH TOWN,Cumberland County,1995,43,43,0,0,0,0
NORTH YARMOUTH TOWN,Cumberland County,1996,32,32,0,0,0,0
NORTH YARMOUTH TOWN,Cumberland County,1997,21,21,0,0,0,0
NORTH YARMOUTH TOWN,Cumberland County,1998,28,28,0,0,0,0
NORTH YARMOUTH TOWN,Cumberland County,1999,35,35,0,0,0,0
NORTH YARMOUTH TOWN,Cumberland County,2000,34,34,0,0,0,0
NORTH YARMOUTH TOWN,Cumberland County,2001,24,24,0,0,0,0
NORTH YARMOUTH TOWN,Cumberland County,2002,29,29,0,0,0,0
NORTH YARMOUTH TOWN,Cumberland County,2003,23,23,0,0,0,0
NORTH YARMOUTH TOWN,Cumberland County,2004,31,31,0,0,0,0
NORTH YARMOUTH TOWN,Cumberland County,2005,28,28,0,0,0,0
NORTH YARMOUTH TOWN,Cumberland County,2006,14,14,0,0,0,0
NORTH YARMOUTH TOWN,Cumberland County,2007,23,20,3,0,3,0
NORTH YARMOUTH TOWN,Cumberland County,2008,6,6,0,0,0,0
NORTH YARMOUTH TOWN,Cumberland County,2009,6,6,0,0,0,0
NORTH YARMOUTH TOWN,Cumberland County,2010,5,5,0,0,0,0
NORTH YARMOUTH TOWN,Cumberland County,2011,9,9,0,0,0,0
NORTH YARMOUTH TOWN,Cumberland County,2012,13,13,0,0,0,0
NORTH YARMOUTH TOWN,Cumberland County,2013,16,16,0,0,0,0
NORTH YARMOUTH TOWN,Cumberland County,2014,11,11,0,0,0,0
NORTH YARMOUTH TOWN,Cumberland County,2015,13,13,0,0,0,0
NORTH YARMOUTH TOWN,Cumberland County,2016,18,18,0,0,0,0
NORTH YARMOUTH TOWN,Cumberland County,2017,24,24,0,0,0,0
PORTLAND,Cumberland County,1980,49,33,16,8,8,0
PORTLAND,Cumberland County,1981,83,37,46,4,20,22
PORTLAND,Cumberland County,1982,144,41,103,4,16,83
PORTLAND,Cumberland County,1983,255,77,178,0,27,151
PORTLAND,Cumberland County,1984,368,139,229,12,24,193
PORTLAND,Cumberland County,1985,699,428,271,28,69,174
PORTLAND,Cumberland County,1986,335,287,48,14,34,0
PORTLAND,Cumberland County,1987,265,215,50,32,18,0
PORTLAND,Cumberland County,1988,336,191,145,20,3,122
PORTLAND,Cumberland County,1989,320,147,173,18,18,137
PORTLAND,Cumberland County,1990,70,60,10,10,0,0
PORTLAND,Cumberland County,1991,71,50,21,4,0,17
PORTLAND,Cumberland County,1992,77,65,12,6,6,0
PORTLAND,Cumberland County,1993,58,58,0,0,0,0
PORTLAND,Cumberland County,1994,72,64,8,4,4,0
PORTLAND,Cumberland County,1995,146,66,80,4,0,76
PORTLAND,Cumberland County,1996,66,59,7,4,3,0
PORTLAND,Cumberland County,1997,72,62,10,10,0,0
PORTLAND,Cumberland County,1998,337,89,248,4,3,241
PORTLAND,Cumberland County,1999,115,93,22,18,4,0
PORTLAND,Cumberland County,2000,160,88,72,16,15,41
PORTLAND,Cumberland County,2001,220,104,116,14,24,78
PORTLAND,Cumberland County,2002,133,61,72,4,13,55
PORTLAND,Cumberland County,2003,264,161,103,8,63,32
PORTLAND,Cumberland County,2004,171,125,46,4,6,36
PORTLAND,Cumberland County,2005,209,127,82,4,10,68
PORTLAND,Cumberland County,2006,148,75,73,14,0,59
PORTLAND,Cumberland County,2007,73,32,41,0,0,41
PORTLAND,Cumberland County,2008,74,23,51,8,0,43
PORTLAND,Cumberland County,2009,30,28,2,2,0,0
PORTLAND,Cumberland County,2010,38,36,2,2,0,0
PORTLAND,Cumberland County,2011,31,29,2,2,0,0
PORTLAND,Cumberland County,2012,40,33,7,4,3,0
PORTLAND,Cumberland County,2013,176,25,151,0,0,151
PORTLAND,Cumberland County,2014,100,36,64,8,0,56
PORTLAND,Cumberland County,2015,151,32,119,8,0,111
PORTLAND,Cumberland County,2016,150,28,122,4,11,107
PORTLAND,Cumberland County,2017,42,27,15,8,0,7
POWNAL TOWN,Cumberland County,1980,3,3,0,0,0,0
POWNAL TOWN,Cumberland County,1981,2,2,0,0,0,0
POWNAL TOWN,Cumberland County,1982,4,4,0,0,0,0
POWNAL TOWN,Cumberland County,1983,5,5,0,0,0,0
POWNAL TOWN,Cumberland County,1984,7,7,0,0,0,0
POWNAL TOWN,Cumberland County,1985,11,11,0,0,0,0
POWNAL TOWN,Cumberland County,1986,14,14,0,0,0,0
POWNAL TOWN,Cumberland County,1987,13,13,0,0,0,0
POWNAL TOWN,Cumberland County,1988,5,5,0,0,0,0
POWNAL TOWN,Cumberland County,1989,9,9,0,0,0,0
POWNAL TOWN,Cumberland County,1990,6,6,0,0,0,0
POWNAL TOWN,Cumberland County,1991,3,3,0,0,0,0
POWNAL TOWN,Cumberland County,1992,2,2,0,0,0,0
POWNAL TOWN,Cumberland County,1993,1,1,0,0,0,0
POWNAL TOWN,Cumberland County,1994,2,2,0,0,0,0
POWNAL TOWN,Cumberland County,1995,2,2,0,0,0,0
POWNAL TOWN,Cumberland County,1996,2,2,0,0,0,0
POWNAL TOWN,Cumberland County,1997,1,1,0,0,0,0
POWNAL TOWN,Cumberland County,1998,10,10,0,0,0,0
POWNAL TOWN,Cumberland County,1999,10,10,0,0,0,0
POWNAL TOWN,Cumberland County,2000,10,10,0,0,0,0
POWNAL TOWN,Cumberland County,2001,11,11,0,0,0,0
POWNAL TOWN,Cumberland County,2002,12,12,0,0,0,0
POWNAL TOWN,Cumberland County,2003,13,13,0,0,0,0
POWNAL TOWN,Cumberland County,2004,14,14,0,0,0,0
POWNAL TOWN,Cumberland County,2005,14,14,0,0,0,0
POWNAL TOWN,Cumberland County,2006,13,13,0,0,0,0
POWNAL TOWN,Cumberland County,2007,7,7,0,0,0,0
POWNAL TOWN,Cumberland County,2008,1,1,0,0,0,0
POWNAL TOWN,Cumberland County,2009,2,2,0,0,0,0
POWNAL TOWN,Cumberland County,2010,1,1,0,0,0,0
POWNAL TOWN,Cumberland County,2011,1,1,0,0,0,0
POWNAL TOWN,Cumberland County,2012,2,2,0,0,0,0
POWNAL TOWN,Cumberland County,2013,9,9,0,0,0,0
POWNAL TOWN,Cumberland County,2014,4,4,0,0,0,0
POWNAL TOWN,Cumberland County,2015,5,5,0,0,0,0
POWNAL TOWN,Cumberland County,2016,10,10,0,0,0,0
POWNAL TOWN,Cumberland County,2017,8,8,0,0,0,0
RAYMOND TOWN,Cumberland County,1980,17,17,0,0,0,0
RAYMOND TOWN,Cumberland County,1981,20,20,0,0,0,0
RAYMOND TOWN,Cumberland County,1982,20,20,0,0,0,0
RAYMOND TOWN,Cumberland County,1983,24,24,0,0,0,0
RAYMOND TOWN,Cumberland County,1984,33,33,0,0,0,0
RAYMOND TOWN,Cumberland County,1985,66,62,4,4,0,0
RAYMOND TOWN,Cumberland County,1986,89,75,14,10,4,0
RAYMOND TOWN,Cumberland County,1987,80,80,0,0,0,0
RAYMOND TOWN,Cumberland County,1988,60,60,0,0,0,0
RAYMOND TOWN,Cumberland County,1989,57,57,0,0,0,0
RAYMOND TOWN,Cumberland County,1990,50,30,20,0,20,0
RAYMOND TOWN,Cumberland County,1991,27,27,0,0,0,0
RAYMOND TOWN,Cumberland County,1992,38,38,0,0,0,0
RAYMOND TOWN,Cumberland County,1993,25,23,2,2,0,0
RAYMOND TOWN,Cumberland County,1994,37,37,0,0,0,0
RAYMOND TOWN,Cumberland County,1995,26,26,0,0,0,0
RAYMOND TOWN,Cumberland County,1996,36,36,0,0,0,0
RAYMOND TOWN,Cumberland County,1997,35,35,0,0,0,0
RAYMOND TOWN,Cumberland County,1998,41,41,0,0,0,0
RAYMOND TOWN,Cumberland County,1999,33,33,0,0,0,0
RAYMOND TOWN,Cumberland County,2000,46,46,0,0,0,0
RAYMOND TOWN,Cumberland County,2001,72,48,24,0,0,24
RAYMOND TOWN,Cumberland County,2002,62,57,5,0,0,5
RAYMOND TOWN,Cumberland County,2003,42,42,0,0,0,0
RAYMOND TOWN,Cumberland County,2004,45,45,0,0,0,0
RAYMOND TOWN,Cumberland County,2005,58,58,0,0,0,0
RAYMOND TOWN,Cumberland County,2006,39,39,0,0,0,0
RAYMOND TOWN,Cumberland County,2007,22,22,0,0,0,0
RAYMOND TOWN,Cumberland County,2008,4,4,0,0,0,0
RAYMOND TOWN,Cumberland County,2009,6,6,0,0,0,0
RAYMOND TOWN,Cumberland County,2010,5,5,0,0,0,0
RAYMOND TOWN,Cumberland County,2011,4,4,0,0,0,0
RAYMOND TOWN,Cumberland County,2012,6,6,0,0,0,0
RAYMOND TOWN,Cumberland County,2013,14,14,0,0,0,0
RAYMOND TOWN,Cumberland County,2014,10,10,0,0,0,0
RAYMOND TOWN,Cumberland County,2015,9,9,0,0,0,0
RAYMOND TOWN,Cumberland County,2016,10,10,0,0,0,0
RAYMOND TOWN,Cumberland County,2017,28,28,0,0,0,0
SCARBOROUGH TOWN,Cumberland County,1980,128,50,78,78,0,0
SCARBOROUGH TOWN,Cumberland County,1981,37,37,0,0,0,0
SCARBOROUGH TOWN,Cumberland County,1982,33,33,0,0,0,0
SCARBOROUGH TOWN,Cumberland County,1983,79,79,0,0,0,0
SCARBOROUGH TOWN,Cumberland County,1984,156,119,37,0,0,37
SCARBOROUGH TOWN,Cumberland County,1985,168,166,2,2,0,0
SCARBOROUGH TOWN,Cumberland County,1986,296,230,66,0,0,66
SCARBOROUGH TOWN,Cumberland County,1987,191,191,0,0,0,0
SCARBOROUGH TOWN,Cumberland County,1988,146,142,4,4,0,0
SCARBOROUGH TOWN,Cumberland County,1989,129,125,4,4,0,0
SCARBOROUGH TOWN,Cumberland County,1990,89,89,0,0,0,0
SCARBOROUGH TOWN,Cumberland County,1991,103,103,0,0,0,0
SCARBOROUGH TOWN,Cumberland County,1992,142,138,4,4,0,0
SCARBOROUGH TOWN,Cumberland County,1993,133,133,0,0,0,0
SCARBOROUGH TOWN,Cumberland County,1994,145,145,0,0,0,0
SCARBOROUGH TOWN,Cumberland County,1995,154,154,0,0,0,0
SCARBOROUGH TOWN,Cumberland County,1996,191,185,6,2,4,0
SCARBOROUGH TOWN,Cumberland County,1997,201,181,20,20,0,0
SCARBOROUGH TOWN,Cumberland County,1998,203,197,6,6,0,0
SCARBOROUGH TOWN,Cumberland County,1999,203,203,0,0,0,0
SCARBOROUGH TOWN,Cumberland County,2000,360,348,12,0,12,0
SCARBOROUGH TOWN,Cumberland County,2001,259,210,49,6,43,0
SCARBOROUGH TOWN,Cumberland County,2002,147,147,0,0,0,0
SCARBOROUGH TOWN,Cumberland County,2003,165,165,0,0,0,0
SCARBOROUGH TOWN,Cumberland County,2004,131,109,22,0,0,22
SCARBOROUGH TOWN,Cumberland County,2005,111,101,10,0,0,10
SCARBOROUGH TOWN,Cumberland County,2006,95,66,29,0,0,29
SCARBOROUGH TOWN,Cumberland County,2007,87,71,16,0,0,16
SCARBOROUGH TOWN,Cumberland County,2008,62,62,0,0,0,0
SCARBOROUGH TOWN,Cumberland County,2009,38,38,0,0,0,0
SCARBOROUGH TOWN,Cumberland County,2010,58,58,0,0,0,0
SCARBOROUGH TOWN,Cumberland County,2011,45,45,0,0,0,0
SCARBOROUGH TOWN,Cumberland County,2012,70,62,8,0,0,8
SCARBOROUGH TOWN,Cumberland County,2013,77,77,0,0,0,0
SCARBOROUGH TOWN,Cumberland County,2014,70,70,0,0,0,0
SCARBOROUGH TOWN,Cumberland County,2015,131,99,32,0,0,32
SCARBOROUGH TOWN,Cumberland County,2016,92,90,2,2,0,0
SCARBOROUGH TOWN,Cumberland County,2017,261,81,180,0,12,168
SEBAGO TOWN,Cumberland County,1980,0,0,0,0,0,0
SEBAGO TOWN,Cumberland County,1981,0,0,0,0,0,0
SEBAGO TOWN,Cumberland County,1982,0,0,0,0,0,0
SEBAGO TOWN,Cumberland County,1983,0,0,0,0,0,0
SEBAGO TOWN,Cumberland County,1984,0,0,0,0,0,0
SEBAGO TOWN,Cumberland County,1985,0,0,0,0,0,0
SEBAGO TOWN,Cumberland County,1986,0,0,0,0,0,0
SEBAGO TOWN,Cumberland County,1987,0,0,0,0,0,0
SEBAGO TOWN,Cumberland County,1988,0,0,0,0,0,0
SEBAGO TOWN,Cumberland County,1989,0,0,0,0,0,0
SEBAGO TOWN,Cumberland County,1990,0,0,0,0,0,0
SEBAGO TOWN,Cumberland County,1991,10,10,0,0,0,0
SEBAGO TOWN,Cumberland County,1992,5,5,0,0,0,0
SEBAGO TOWN,Cumberland County,1993,11,11,0,0,0,0
SEBAGO TOWN,Cumberland County,1994,9,9,0,0,0,0
SEBAGO TOWN,Cumberland County,1995,5,5,0,0,0,0
SEBAGO TOWN,Cumberland County,1996,10,10,0,0,0,0
SEBAGO TOWN,Cumberland County,1997,10,10,0,0,0,0
SEBAGO TOWN,Cumberland County,1998,9,9,0,0,0,0
SEBAGO TOWN,Cumberland County,1999,17,17,0,0,0,0
SEBAGO TOWN,Cumberland County,2000,13,13,0,0,0,0
SEBAGO TOWN,Cumberland County,2001,15,15,0,0,0,0
SEBAGO TOWN,Cumberland County,2002,21,21,0,0,0,0
SEBAGO TOWN,Cumberland County,2003,26,26,0,0,0,0
SEBAGO TOWN,Cumberland County,2004,31,31,0,0,0,0
SEBAGO TOWN,Cumberland County,2005,31,31,0,0,0,0
SEBAGO TOWN,Cumberland County,2006,27,27,0,0,0,0
SEBAGO TOWN,Cumberland County,2007,23,23,0,0,0,0
SEBAGO TOWN,Cumberland County,2008,17,17,0,0,0,0
SEBAGO TOWN,Cumberland County,2009,8,8,0,0,0,0
SEBAGO TOWN,Cumberland County,2010,9,9,0,0,0,0
SEBAGO TOWN,Cumberland County,2011,7,7,0,0,0,0
SEBAGO TOWN,Cumberland County,2012,8,8,0,0,0,0
SEBAGO TOWN,Cumberland County,2013,11,11,0,0,0,0
SEBAGO TOWN,Cumberland County,2014,13,13,0,0,0,0
SEBAGO TOWN,Cumberland County,2015,18,16,2,2,0,0
SEBAGO TOWN,Cumberland County,2016,19,17,2,2,0,0
SEBAGO TOWN,Cumberland County,2017,18,16,2,2,0,0
SOUTH PORTLAND,Cumberland County,1980,137,56,81,2,4,75
SOUTH PORTLAND,Cumberland County,1981,31,23,8,2,0,6
SOUTH PORTLAND,Cumberland County,1982,61,33,28,0,0,28
SOUTH PORTLAND,Cumberland County,1983,106,63,43,2,12,29
SOUTH PORTLAND,Cumberland County,1984,147,81,66,2,4,60
SOUTH PORTLAND,Cumberland County,1985,181,95,86,6,12,68
SOUTH PORTLAND,Cumberland County,1986,386,78,308,4,4,300
SOUTH PORTLAND,Cumberland County,1987,283,83,200,0,6,194
SOUTH PORTLAND,Cumberland County,1988,38,38,0,0,0,0
SOUTH PORTLAND,Cumberland County,1989,36,20,16,0,6,10
SOUTH PORTLAND,Cumberland County,1990,22,22,0,0,0,0
SOUTH PORTLAND,Cumberland County,1991,24,24,0,0,0,0
SOUTH PORTLAND,Cumberland County,1992,106,26,80,0,0,80
SOUTH PORTLAND,Cumberland County,1993,26,26,0,0,0,0
SOUTH PORTLAND,Cumberland County,1994,35,33,2,2,0,0
SOUTH PORTLAND,Cumberland County,1995,37,34,3,0,3,0
SOUTH PORTLAND,Cumberland County,1996,32,32,0,0,0,0
SOUTH PORTLAND,Cumberland County,1997,55,53,2,2,0,0
SOUTH PORTLAND,Cumberland County,1998,72,72,0,0,0,0
SOUTH PORTLAND,Cumberland County,1999,71,71,0,0,0,0
SOUTH PORTLAND,Cumberland County,2000,74,74,0,0,0,0
SOUTH PORTLAND,Cumberland County,2001,34,34,0,0,0,0
SOUTH PORTLAND,Cumberland County,2002,219,71,148,0,12,136
SOUTH PORTLAND,Cumberland County,2003,129,127,2,2,0,0
SOUTH PORTLAND,Cumberland County,2004,174,60,114,0,0,114
SOUTH PORTLAND,Cumberland County,2005,205,88,117,2,0,115
SOUTH PORTLAND,Cumberland County,2006,70,70,0,0,0,0
SOUTH PORTLAND,Cumberland County,2007,98,41,57,0,0,57
SOUTH PORTLAND,Cumberland County,2008,36,34,2,2,0,0
SOUTH PORTLAND,Cumberland County,2009,32,32,0,0,0,0
SOUTH PORTLAND,Cumberland County,2010,32,32,0,0,0,0
SOUTH PORTLAND,Cumberland County,2011,17,17,0,0,0,0
SOUTH PORTLAND,Cumberland County,2012,63,21,42,0,0,42
SOUTH PORTLAND,Cumberland County,2013,78,26,52,0,4,48
SOUTH PORTLAND,Cumberland County,2014,50,31,19,0,0,19
SOUTH PORTLAND,Cumberland County,2015,35,27,8,0,8,0
SOUTH PORTLAND,Cumberland County,2016,39,13,26,2,0,24
SOUTH PORTLAND,Cumberland County,2017,136,40,96,2,0,94
STANDISH TOWN,Cumberland County,1980,25,25,0,0,0,0
STANDISH TOWN,Cumberland County,1981,34,34,0,0,0,0
STANDISH TOWN,Cumberland County,1982,20,20,0,0,0,0
STANDISH TOWN,Cumberland County,1983,31,29,2,2,0,0
STANDISH TOWN,Cumberland County,1984,67,63,4,0,4,0
STANDISH TOWN,Cumberland County,1985,6,6,0,0,0,0
STANDISH TOWN,Cumberland County,1986,116,116,0,0,0,0
STANDISH TOWN,Cumberland County,1987,124,120,4,0,4,0
STANDISH TOWN,Cumberland County,1988,102,98,4,0,4,0
STANDISH TOWN,Cumberland County,1989,52,48,4,4,0,0
STANDISH TOWN,Cumberland County,1990,31,31,0,0,0,0
STANDISH TOWN,Cumberland County,1991,53,53,0,0,0,0
STANDISH TOWN,Cumberland County,1992,46,46,0,0,0,0
STANDISH TOWN,Cumberland County,1993,60,60,0,0,0,0
STANDISH TOWN,Cumberland County,1994,51,51,0,0,0,0
STANDISH TOWN,Cumberland County,1995,67,67,0,0,0,0
STANDISH TOWN,Cumberland County,1996,83,83,0,0,0,0
STANDISH TOWN,Cumberland County,1997,63,63,0,0,0,0
STANDISH TOWN,Cumberland County,1998,117,117,0,0,0,0
STANDISH TOWN,Cumberland County,1999,121,121,0,0,0,0
STANDISH TOWN,Cumberland County,2000,114,114,0,0,0,0
STANDISH TOWN,Cumberland County,2001,79,79,0,0,0,0
STANDISH TOWN,Cumberland County,2002,70,68,2,2,0,0
STANDISH TOWN,Cumberland County,2003,53,53,0,0,0,0
STANDISH TOWN,Cumberland County,2004,42,42,0,0,0,0
STANDISH TOWN,Cumberland County,2005,36,36,0,0,0,0
STANDISH TOWN,Cumberland County,2006,42,42,0,0,0,0
STANDISH TOWN,Cumberland County,2007,29,29,0,0,0,0
STANDISH TOWN,Cumberland County,2008,18,18,0,0,0,0
STANDISH TOWN,Cumberland County,2009,17,17,0,0,0,0
STANDISH TOWN,Cumberland County,2010,18,18,0,0,0,0
STANDISH TOWN,Cumberland County,2011,8,8,0,0,0,0
STANDISH TOWN,Cumberland County,2012,18,18,0,0,0,0
STANDISH TOWN,Cumberland County,2013,23,23,0,0,0,0
STANDISH TOWN,Cumberland County,2014,30,30,0,0,0,0
STANDISH TOWN,Cumberland County,2015,20,20,0,0,0,0
STANDISH TOWN,Cumberland County,2016,38,38,0,0,0,0
STANDISH TOWN,Cumberland County,2017,35,35,0,0,0,0
WESTBROOK,Cumberland County,1980,24,19,5,2,3,0
WESTBROOK,Cumberland County,1981,22,22,0,0,0,0
WESTBROOK,Cumberland County,1982,17,11,6,6,0,0
WESTBROOK,Cumberland County,1983,57,31,26,0,0,26
WESTBROOK,Cumberland County,1984,90,28,62,2,4,56
WESTBROOK,Cumberland County,1985,67,55,12,0,12,0
WESTBROOK,Cumberland County,1986,125,62,63,8,12,43
WESTBROOK,Cumberland County,1987,68,45,23,6,12,5
WESTBROOK,Cumberland County,1988,98,86,12,2,4,6
WESTBROOK,Cumberland County,1989,44,32,12,2,0,10
WESTBROOK,Cumberland County,1990,134,34,100,0,0,100
WESTBROOK,Cumberland County,1991,22,22,0,0,0,0
WESTBROOK,Cumberland County,1992,28,28,0,0,0,0
WESTBROOK,Cumberland County,1993,28,28,0,0,0,0
WESTBROOK,Cumberland County,1994,26,26,0,0,0,0
WESTBROOK,Cumberland County,1995,32,32,0,0,0,0
WESTBROOK,Cumberland County,1996,32,32,0,0,0,0
WESTBROOK,Cumberland County,1997,106,32,74,0,31,43
WESTBROOK,Cumberland County,1998,48,48,0,0,0,0
WESTBROOK,Cumberland County,1999,33,33,0,0,0,0
WESTBROOK,Cumberland County,2000,45,45,0,0,0,0
WESTBROOK,Cumberland County,2001,43,43,0,0,0,0
WESTBROOK,Cumberland County,2002,28,28,0,0,0,0
WESTBROOK,Cumberland County,2003,54,44,10,10,0,0
WESTBROOK,Cumberland County,2004,110,102,8,0,8,0
WESTBROOK,Cumberland County,2005,171,62,109,34,17,58
WESTBROOK,Cumberland County,2006,92,46,46,30,0,16
WESTBROOK,Cumberland County,2007,165,69,96,18,11,67
WESTBROOK,Cumberland County,2008,33,25,8,8,0,0
WESTBROOK,Cumberland County,2009,45,37,8,0,8,0
WESTBROOK,Cumberland County,2010,32,30,2,2,0,0
WESTBROOK,Cumberland County,2011,23,20,3,0,3,0
WESTBROOK,Cumberland County,2012,62,28,34,16,4,14
WESTBROOK,Cumberland County,2013,60,28,32,22,0,10
WESTBROOK,Cumberland County,2014,36,28,8,2,6,0
WESTBROOK,Cumberland County,2015,194,35,159,16,0,143
WESTBROOK,Cumberland County,2016,231,128,103,0,7,96
WESTBROOK,Cumberland County,2017,157,57,100,4,0,96
WINDHAM TOWN,Cumberland County,1980,59,44,15,2,0,13
WINDHAM TOWN,Cumberland County,1981,53,45,8,2,0,6
WINDHAM TOWN,Cumberland County,1982,65,65,0,0,0,0
WINDHAM TOWN,Cumberland County,1983,87,71,16,2,8,6
WINDHAM TOWN,Cumberland County,1984,103,80,23,2,15,6
WINDHAM TOWN,Cumberland County,1985,169,74,95,14,52,29
WINDHAM TOWN,Cumberland County,1986,154,84,70,10,53,7
WINDHAM TOWN,Cumberland County,1987,121,111,10,6,4,0
WINDHAM TOWN,Cumberland County,1988,124,102,22,2,0,20
WINDHAM TOWN,Cumberland County,1989,103,77,26,26,0,0
WINDHAM TOWN,Cumberland County,1990,81,65,16,16,0,0
WINDHAM TOWN,Cumberland County,1991,80,76,4,4,0,0
WINDHAM TOWN,Cumberland County,1992,99,99,0,0,0,0
WINDHAM TOWN,Cumberland County,1993,123,103,20,0,0,20
WINDHAM TOWN,Cumberland County,1994,108,100,8,0,8,0
WINDHAM TOWN,Cumberland County,1995,87,83,4,0,4,0
WINDHAM TOWN,Cumberland County,1996,113,93,20,2,8,10
WINDHAM TOWN,Cumberland County,1997,101,99,2,2,0,0
WINDHAM TOWN,Cumberland County,1998,164,158,6,2,4,0
WINDHAM TOWN,Cumberland County,1999,151,137,14,2,12,0
WINDHAM TOWN,Cumberland County,2000,104,104,0,0,0,0
WINDHAM TOWN,Cumberland County,2001,104,102,2,2,0,0
WINDHAM TOWN,Cumberland County,2002,158,156,2,2,0,0
WINDHAM TOWN,Cumberland County,2003,133,133,0,0,0,0
WINDHAM TOWN,Cumberland County,2004,136,136,0,0,0,0
WINDHAM TOWN,Cumberland County,2005,139,115,24,0,0,24
WINDHAM TOWN,Cumberland County,2006,88,88,0,0,0,0
WINDHAM TOWN,Cumberland County,2007,90,90,0,0,0,0
WINDHAM TOWN,Cumberland County,2008,52,52,0,0,0,0
WINDHAM TOWN,Cumberland County,2009,59,59,0,0,0,0
WINDHAM TOWN,Cumberland County,2010,62,62,0,0,0,0
WINDHAM TOWN,Cumberland County,2011,44,44,0,0,0,0
WINDHAM TOWN,Cumberland County,2012,66,66,0,0,0,0
WINDHAM TOWN,Cumberland County,2013,60,60,0,0,0,0
WINDHAM TOWN,Cumberland County,2014,91,79,12,0,12,0
WINDHAM TOWN,Cumberland County,2015,95,95,0,0,0,0
WINDHAM TOWN,Cumberland County,2016,121,109,12,12,0,0
WINDHAM TOWN,Cumberland County,2017,100,100,0,0,0,0
YARMOUTH TOWN,Cumberland County,1980,27,17,10,0,0,10
YARMOUTH TOWN,Cumberland County,1981,39,20,19,0,9,10
YARMOUTH TOWN,Cumberland County,1982,25,22,3,0,3,0
YARMOUTH TOWN,Cumberland County,1983,60,39,21,0,15,6
YARMOUTH TOWN,Cumberland County,1984,96,37,59,0,32,27
YARMOUTH TOWN,Cumberland County,1985,182,58,124,16,91,17
YARMOUTH TOWN,Cumberland County,1986,95,58,37,0,21,16
YARMOUTH TOWN,Cumberland County,1987,74,74,0,0,0,0
YARMOUTH TOWN,Cumberland County,1988,46,46,0,0,0,0
YARMOUTH TOWN,Cumberland County,1989,31,27,4,0,4,0
YARMOUTH TOWN,Cumberland County,1990,46,46,0,0,0,0
YARMOUTH TOWN,Cumberland County,1991,30,27,3,0,3,0
YARMOUTH TOWN,Cumberland County,1992,45,45,0,0,0,0
YARMOUTH TOWN,Cumberland County,1993,36,32,4,0,4,0
YARMOUTH TOWN,Cumberland County,1994,18,18,0,0,0,0
YARMOUTH TOWN,Cumberland County,1995,25,23,2,2,0,0
YARMOUTH TOWN,Cumberland County,1996,37,37,0,0,0,0
YARMOUTH TOWN,Cumberland County,1997,32,32,0,0,0,0
YARMOUTH TOWN,Cumberland County,1998,38,24,14,14,0,0
YARMOUTH TOWN,Cumberland County,1999,28,26,2,2,0,0
YARMOUTH TOWN,Cumberland County,2000,29,29,0,0,0,0
YARMOUTH TOWN,Cumberland County,2001,13,13,0,0,0,0
YARMOUTH TOWN,Cumberland County,2002,18,18,0,0,0,0
YARMOUTH TOWN,Cumberland County,2003,21,15,6,6,0,0
YARMOUTH TOWN,Cumberland County,2004,18,18,0,0,0,0
YARMOUTH TOWN,Cumberland County,2005,16,16,0,0,0,0
YARMOUTH TOWN,Cumberland County,2006,7,7,0,0,0,0
YARMOUTH TOWN,Cumberland County,2007,11,11,0,0,0,0
YARMOUTH TOWN,Cumberland County,2008,10,10,0,0,0,0
YARMOUTH TOWN,Cumberland County,2009,15,15,0,0,0,0
YARMOUTH TOWN,Cumberland County,2010,20,20,0,0,0,0
YARMOUTH TOWN,Cumberland County,2011,14,14,0,0,0,0
YARMOUTH TOWN,Cumberland County,2012,16,16,0,0,0,0
YARMOUTH TOWN,Cumberland County,2013,13,9,4,4,0,0
YARMOUTH TOWN,Cumberland County,2014,14,14,0,0,0,0
YARMOUTH TOWN,Cumberland County,2015,9,9,0,0,0,0
YARMOUTH TOWN,Cumberland County,2016,10,10,0,0,0,0
YARMOUTH TOWN,Cumberland County,2017,42,42,0,0,0,0
BETHEL TOWN,Oxford County,1980,0,0,0,0,0,0
BETHEL TOWN,Oxford County,1981,0,0,0,0,0,0
BETHEL TOWN,Oxford County,1982,31,7,24,0,4,20
BETHEL TOWN,Oxford County,1983,15,9,6,0,0,6
BETHEL TOWN,Oxford County,1984,35,10,25,0,3,22
BETHEL TOWN,Oxford County,1985,24,14,10,0,0,10
BETHEL TOWN,Oxford County,1986,29,14,15,0,0,15
BETHEL TOWN,Oxford County,1987,19,14,5,0,0,5
BETHEL TOWN,Oxford County,1988,38,13,25,0,0,25
BETHEL TOWN,Oxford County,1989,13,13,0,0,0,0
BETHEL TOWN,Oxford County,1990,10,10,0,0,0,0
BETHEL TOWN,Oxford County,1991,9,9,0,0,0,0
BETHEL TOWN,Oxford County,1992,42,18,24,0,0,24
BETHEL TOWN,Oxford County,1993,45,19,26,0,0,26
BETHEL TOWN,Oxford County,1994,59,19,40,0,0,40
BETHEL TOWN,Oxford County,1995,31,19,12,4,8,0
BETHEL TOWN,Oxford County,1996,10,8,2,2,0,0
BETHEL TOWN,Oxford County,1997,10,10,0,0,0,0
BETHEL TOWN,Oxford County,1998,24,20,4,0,4,0
BETHEL TOWN,Oxford County,1999,16,16,0,0,0,0
BETHEL TOWN,Oxford County,2000,18,18,0,0,0,0
BETHEL TOWN,Oxford County,2001,18,18,0,0,0,0
BETHEL TOWN,Oxford County,2002,20,20,0,0,0,0
BETHEL TOWN,Oxford County,2003,19,19,0,0,0,0
BETHEL TOWN,Oxford County,2004,46,46,0,0,0,0
BETHEL TOWN,Oxford County,2005,40,40,0,0,0,0
BETHEL TOWN,Oxford County,2006,34,34,0,0,0,0
BETHEL TOWN,Oxford County,2007,25,25,0,0,0,0
BETHEL TOWN,Oxford County,2008,18,18,0,0,0,0
BETHEL TOWN,Oxford County,2009,14,14,0,0,0,0
BETHEL TOWN,Oxford County,2010,15,15,0,0,0,0
BETHEL TOWN,Oxford County,2011,10,10,0,0,0,0
BETHEL TOWN,Oxford County,2012,15,15,0,0,0,0
BETHEL TOWN,Oxford County,2013,25,25,0,0,0,0
BETHEL TOWN,Oxford County,2014,19,19,0,0,0,0
BETHEL TOWN,Oxford County,2015,23,23,0,0,0,0
BETHEL TOWN,Oxford County,2016,17,17,0,0,0,0
BETHEL TOWN,Oxford County,2017,23,23,0,0,0,0
DENMARK TOWN,Oxford County,1980,0,0,0,0,0,0
DENMARK TOWN,Oxford County,1981,0,0,0,0,0,0
DENMARK TOWN,Oxford County,1982,6,6,0,0,0,0
DENMARK TOWN,Oxford County,1983,12,12,0,0,0,0
DENMARK TOWN,Oxford County,1984,13,13,0,0,0,0
DENMARK TOWN,Oxford County,1985,18,18,0,0,0,0
DENMARK TOWN,Oxford County,1986,6,6,0,0,0,0
DENMARK TOWN,Oxford County,1987,7,7,0,0,0,0
DENMARK TOWN,Oxford County,1988,43,43,0,0,0,0
DENMARK TOWN,Oxford County,1989,35,35,0,0,0,0
DENMARK TOWN,Oxford County,1990,27,27,0,0,0,0
DENMARK TOWN,Oxford County,1991,23,23,0,0,0,0
DENMARK TOWN,Oxford County,1992,9,9,0,0,0,0
DENMARK TOWN,Oxford County,1993,6,6,0,0,0,0
DENMARK TOWN,Oxford County,1994,7,7,0,0,0,0
DENMARK TOWN,Oxford County,1995,7,7,0,0,0,0
DENMARK TOWN,Oxford County,1996,6,6,0,0,0,0
DENMARK TOWN,Oxford County,1997,3,3,0,0,0,0
DENMARK TOWN,Oxford County,1998,2,2,0,0,0,0
DENMARK TOWN,Oxford County,1999,0,0,0,0,0,0
DENMARK TOWN,Oxford County,2000,18,18,0,0,0,0
DENMARK TOWN,Oxford County,2001,8,8,0,0,0,0
DENMARK TOWN,Oxford County,2002,32,32,0,0,0,0
DENMARK TOWN,Oxford County,2003,30,30,0,0,0,0
DENMARK TOWN,Oxford County,2004,23,23,0,0,0,0
DENMARK TOWN,Oxford County,2005,20,20,0,0,0,0
DENMARK TOWN,Oxford County,2006,17,17,0,0,0,0
DENMARK TOWN,Oxford County,2007,11,11,0,0,0,0
DENMARK TOWN,Oxford County,2008,8,8,0,0,0,0
DENMARK TOWN,Oxford County,2009,6,6,0,0,0,0
DENMARK TOWN,Oxford County,2010,6,6,0,0,0,0
DENMARK TOWN,Oxford County,2011,4,4,0,0,0,0
DENMARK TOWN,Oxford County,2012,4,4,0,0,0,0
DENMARK TOWN,Oxford County,2013,4,4,0,0,0,0
DENMARK TOWN,Oxford County,2014,3,3,0,0,0,0
DENMARK TOWN,Oxford County,2015,4,4,0,0,0,0
DENMARK TOWN,Oxford County,2016,4,4,0,0,0,0
DENMARK TOWN,Oxford County,2017,4,4,0,0,0,0
HIRAM TOWN,Oxford County,1980,10,10,0,0,0,0
HIRAM TOWN,Oxford County,1981,8,8,0,0,0,0
HIRAM TOWN,Oxford County,1982,8,8,0,0,0,0
HIRAM TOWN,Oxford County,1983,10,10,0,0,0,0
HIRAM TOWN,Oxford County,1984,11,11,0,0,0,0
HIRAM TOWN,Oxford County,1985,15,15,0,0,0,0
HIRAM TOWN,Oxford County,1986,16,16,0,0,0,0
HIRAM TOWN,Oxford County,1987,19,19,0,0,0,0
HIRAM TOWN,Oxford County,1988,16,16,0,0,0,0
HIRAM TOWN,Oxford County,1989,8,8,0,0,0,0
HIRAM TOWN,Oxford County,1990,10,10,0,0,0,0
HIRAM TOWN,Oxford County,1991,3,3,0,0,0,0
HIRAM TOWN,Oxford County,1992,11,11,0,0,0,0
HIRAM TOWN,Oxford County,1993,10,10,0,0,0,0
HIRAM TOWN,Oxford County,1994,6,6,0,0,0,0
HIRAM TOWN,Oxford County,1995,7,7,0,0,0,0
HIRAM TOWN,Oxford County,1996,12,10,2,2,0,0
HIRAM TOWN,Oxford County,1997,6,6,0,0,0,0
HIRAM TOWN,Oxford County,1998,7,7,0,0,0,0
HIRAM TOWN,Oxford County,1999,9,9,0,0,0,0
HIRAM TOWN,Oxford County,2000,7,7,0,0,0,0
HIRAM TOWN,Oxford County,2001,16,16,0,0,0,0
HIRAM TOWN,Oxford County,2002,7,7,0,0,0,0
HIRAM TOWN,Oxford County,2003,23,23,0,0,0,0
HIRAM TOWN,Oxford County,2004,27,27,0,0,0,0
HIRAM TOWN,Oxford County,2005,12,12,0,0,0,0
HIRAM TOWN,Oxford County,2006,10,10,0,0,0,0
HIRAM TOWN,Oxford County,2007,18,18,0,0,0,0
HIRAM TOWN,Oxford County,2008,7,7,0,0,0,0
HIRAM TOWN,Oxford County,2009,4,4,0,0,0,0
HIRAM TOWN,Oxford County,2010,6,6,0,0,0,0
HIRAM TOWN,Oxford County,2011,6,6,0,0,0,0
HIRAM TOWN,Oxford County,2012,7,7,0,0,0,0
HIRAM TOWN,Oxford County,2013,0,0,0,0,0,0
HIRAM TOWN,Oxford County,2014,3,3,0,0,0,0
HIRAM TOWN,Oxford County,2015,3,3,0,0,0,0
HIRAM TOWN,Oxford County,2016,6,6,0,0,0,0
HIRAM TOWN,Oxford County,2017,5,5,0,0,0,0
LOVELL TOWN,Oxford County,1980,0,0,0,0,0,0
LOVELL TOWN,Oxford County,1981,0,0,0,0,0,0
LOVELL TOWN,Oxford County,1982,3,3,0,0,0,0
LOVELL TOWN,Oxford County,1983,4,4,0,0,0,0
LOVELL TOWN,Oxford County,1984,4,4,0,0,0,0
LOVELL TOWN,Oxford County,1985,5,5,0,0,0,0
LOVELL TOWN,Oxford County,1986,16,16,0,0,0,0
LOVELL TOWN,Oxford County,1987,19,19,0,0,0,0
LOVELL TOWN,Oxford County,1988,18,18,0,0,0,0
LOVELL TOWN,Oxford County,1989,14,14,0,0,0,0
LOVELL TOWN,Oxford County,1990,11,11,0,0,0,0
LOVELL TOWN,Oxford County,1991,9,9,0,0,0,0
LOVELL TOWN,Oxford County,1992,11,11,0,0,0,0
LOVELL TOWN,Oxford County,1993,13,13,0,0,0,0
LOVELL TOWN,Oxford County,1994,8,8,0,0,0,0
LOVELL TOWN,Oxford County,1995,11,11,0,0,0,0
LOVELL TOWN,Oxford County,1996,8,8,0,0,0,0
LOVELL TOWN,Oxford County,1997,12,12,0,0,0,0
LOVELL TOWN,Oxford County,1998,6,6,0,0,0,0
LOVELL TOWN,Oxford County,1999,16,16,0,0,0,0
LOVELL TOWN,Oxford County,2000,16,16,0,0,0,0
LOVELL TOWN,Oxford County,2001,14,14,0,0,0,0
LOVELL TOWN,Oxford County,2002,21,21,0,0,0,0
LOVELL TOWN,Oxford County,2003,20,20,0,0,0,0
LOVELL TOWN,Oxford County,2004,23,23,0,0,0,0
LOVELL TOWN,Oxford County,2005,20,20,0,0,0,0
LOVELL TOWN,Oxford County,2006,17,17,0,0,0,0
LOVELL TOWN,Oxford County,2007,13,13,0,0,0,0
LOVELL TOWN,Oxford County,2008,9,9,0,0,0,0
LOVELL TOWN,Oxford County,2009,7,7,0,0,0,0
LOVELL TOWN,Oxford County,2010,7,7,0,0,0,0
LOVELL TOWN,Oxford County,2011,5,5,0,0,0,0
LOVELL TOWN,Oxford County,2012,5,5,0,0,0,0
LOVELL TOWN,Oxford County,2013,5,5,0,0,0,0
LOVELL TOWN,Oxford County,2014,5,5,0,0,0,0
LOVELL TOWN,Oxford County,2015,5,5,0,0,0,0
LOVELL TOWN,Oxford County,2016,2,2,0,0,0,0
LOVELL TOWN,Oxford County,2017,2,2,0,0,0,0
NORWAY TOWN,Oxford County,1980,0,0,0,0,0,0
NORWAY TOWN,Oxford County,1981,0,0,0,0,0,0
NORWAY TOWN,Oxford County,1982,9,9,0,0,0,0
NORWAY TOWN,Oxford County,1983,9,9,0,0,0,0
NORWAY TOWN,Oxford County,1984,48,14,34,0,34,0
NORWAY TOWN,Oxford County,1985,41,16,25,0,0,25
NORWAY TOWN,Oxford County,1986,38,38,0,0,0,0
NORWAY TOWN,Oxford County,1987,36,36,0,0,0,0
NORWAY TOWN,Oxford County,1988,32,30,2,2,0,0
NORWAY TOWN,Oxford County,1989,15,15,0,0,0,0
NORWAY TOWN,Oxford County,1990,23,21,2,2,0,0
NORWAY TOWN,Oxford County,1991,17,17,0,0,0,0
NORWAY TOWN,Oxford County,1992,15,15,0,0,0,0
NORWAY TOWN,Oxford County,1993,14,14,0,0,0,0
NORWAY TOWN,Oxford County,1994,16,16,0,0,0,0
NORWAY TOWN,Oxford County,1995,15,15,0,0,0,0
NORWAY TOWN,Oxford County,1996,15,15,0,0,0,0
NORWAY TOWN,Oxford County,1997,8,8,0,0,0,0
NORWAY TOWN,Oxford County,1998,10,10,0,0,0,0
NORWAY TOWN,Oxford County,1999,8,8,0,0,0,0
NORWAY TOWN,Oxford County,2000,22,22,0,0,0,0
NORWAY TOWN,Oxford County,2001,23,23,0,0,0,0
NORWAY TOWN,Oxford County,2002,28,28,0,0,0,0
NORWAY TOWN,Oxford County,2003,29,29,0,0,0,0
NORWAY TOWN,Oxford County,2004,37,37,0,0,0,0
NORWAY TOWN,Oxford County,2005,33,33,0,0,0,0
NORWAY TOWN,Oxford County,2006,28,28,0,0,0,0
NORWAY TOWN,Oxford County,2007,21,21,0,0,0,0
NORWAY TOWN,Oxford County,2008,15,15,0,0,0,0
NORWAY TOWN,Oxford County,2009,12,12,0,0,0,0
NORWAY TOWN,Oxford County,2010,13,13,0,0,0,0
NORWAY TOWN,Oxford County,2011,6,6,0,0,0,0
NORWAY TOWN,Oxford County,2012,8,8,0,0,0,0
NORWAY TOWN,Oxford County,2013,5,5,0,0,0,0
NORWAY TOWN,Oxford County,2014,5,5,0,0,0,0
NORWAY TOWN,Oxford County,2015,5,5,0,0,0,0
NORWAY TOWN,Oxford County,2016,5,5,0,0,0,0
NORWAY TOWN,Oxford County,2017,14,14,0,0,0,0
OTISFIELD TOWN,Oxford County,1980,0,0,0,0,0,0
OTISFIELD TOWN,Oxford County,1981,10,8,2,2,0,0
OTISFIELD TOWN,Oxford County,1982,7,7,0,0,0,0
OTISFIELD TOWN,Oxford County,1983,16,16,0,0,0,0
OTISFIELD TOWN,Oxford County,1984,13,13,0,0,0,0
OTISFIELD TOWN,Oxford County,1985,18,18,0,0,0,0
OTISFIELD TOWN,Oxford County,1986,14,14,0,0,0,0
OTISFIELD TOWN,Oxford County,1987,31,31,0,0,0,0
OTISFIELD TOWN,Oxford County,1988,29,29,0,0,0,0
OTISFIELD TOWN,Oxford County,1989,13,13,0,0,0,0
OTISFIELD TOWN,Oxford County,1990,10,10,0,0,0,0
OTISFIELD TOWN,Oxford County,1991,9,7,2,2,0,0
OTISFIELD TOWN,Oxford County,1992,7,7,0,0,0,0
OTISFIELD TOWN,Oxford County,1993,9,9,0,0,0,0
OTISFIELD TOWN,Oxford County,1994,6,6,0,0,0,0
OTISFIELD TOWN,Oxford County,1995,7,7,0,0,0,0
OTISFIELD TOWN,Oxford County,1996,6,6,0,0,0,0
OTISFIELD TOWN,Oxford County,1997,7,7,0,0,0,0
OTISFIELD TOWN,Oxford County,1998,6,6,0,0,0,0
OTISFIELD TOWN,Oxford County,1999,7,7,0,0,0,0
OTISFIELD TOWN,Oxford County,2000,6,6,0,0,0,0
OTISFIELD TOWN,Oxford County,2001,5,5,0,0,0,0
OTISFIELD TOWN,Oxford County,2002,11,11,0,0,0,0
OTISFIELD TOWN,Oxford County,2003,19,17,2,2,0,0
OTISFIELD TOWN,Oxford County,2004,3,3,0,0,0,0
OTISFIELD TOWN,Oxford County,2005,38,38,0,0,0,0
OTISFIELD TOWN,Oxford County,2006,35,35,0,0,0,0
OTISFIELD TOWN,Oxford County,2007,17,17,0,0,0,0
OTISFIELD TOWN,Oxford County,2008,12,12,0,0,0,0
OTISFIELD TOWN,Oxford County,2009,11,11,0,0,0,0
OTISFIELD TOWN,Oxford County,2010,4,4,0,0,0,0
OTISFIELD TOWN,Oxford County,2011,9,9,0,0,0,0
OTISFIELD TOWN,Oxford County,2012,4,4,0,0,0,0
OTISFIELD TOWN,Oxford County,2013,2,2,0,0,0,0
OTISFIELD TOWN,Oxford County,2014,7,7,0,0,0,0
OTISFIELD TOWN,Oxford County,2015,5,5,0,0,0,0
OTISFIELD TOWN,Oxford County,2016,11,11,0,0,0,0
OTISFIELD TOWN,Oxford County,2017,15,15,0,0,0,0
STONEHAM TOWN,Oxford County,1980,0,0,0,0,0,0
STONEHAM TOWN,Oxford County,1981,0,0,0,0,0,0
STONEHAM TOWN,Oxford County,1982,0,0,0,0,0,0
STONEHAM TOWN,Oxford County,1983,0,0,0,0,0,0
STONEHAM TOWN,Oxford County,1984,0,0,0,0,0,0
STONEHAM TOWN,Oxford County,1985,0,0,0,0,0,0
STONEHAM TOWN,Oxford County,1986,0,0,0,0,0,0
STONEHAM TOWN,Oxford County,1987,0,0,0,0,0,0
STONEHAM TOWN,Oxford County,1988,0,0,0,0,0,0
STONEHAM TOWN,Oxford County,1989,0,0,0,0,0,0
STONEHAM TOWN,Oxford County,1990,0,0,0,0,0,0
STONEHAM TOWN,Oxford County,1991,0,0,0,0,0,0
STONEHAM TOWN,Oxford County,1992,0,0,0,0,0,0
STONEHAM TOWN,Oxford County,1993,0,0,0,0,0,0
STONEHAM TOWN,Oxford County,1994,2,2,0,0,0,0
STONEHAM TOWN,Oxford County,1995,3,3,0,0,0,0
STONEHAM TOWN,Oxford County,1996,3,3,0,0,0,0
STONEHAM TOWN,Oxford County,1997,7,7,0,0,0,0
STONEHAM TOWN,Oxford County,1998,0,0,0,0,0,0
STONEHAM TOWN,Oxford County,1999,2,2,0,0,0,0
STONEHAM TOWN,Oxford County,2000,4,2,2,2,0,0
STONEHAM TOWN,Oxford County,2001,8,8,0,0,0,0
STONEHAM TOWN,Oxford County,2002,9,9,0,0,0,0
STONEHAM TOWN,Oxford County,2003,6,6,0,0,0,0
STONEHAM TOWN,Oxford County,2004,6,6,0,0,0,0
STONEHAM TOWN,Oxford County,2005,6,6,0,0,0,0
STONEHAM TOWN,Oxford County,2006,7,7,0,0,0,0
STONEHAM TOWN,Oxford County,2007,5,5,0,0,0,0
STONEHAM TOWN,Oxford County,2008,2,2,0,0,0,0
STONEHAM TOWN,Oxford County,2009,2,2,0,0,0,0
STONEHAM TOWN,Oxford County,2010,1,1,0,0,0,0
STONEHAM TOWN,Oxford County,2011,2,2,0,0,0,0
STONEHAM TOWN,Oxford County,2012,2,2,0,0,0,0
STONEHAM TOWN,Oxford County,2013,3,3,0,0,0,0
STONEHAM TOWN,Oxford County,2014,3,3,0,0,0,0
STONEHAM TOWN,Oxford County,2015,3,3,0,0,0,0
STONEHAM TOWN,Oxford County,2016,3,3,0,0,0,0
STONEHAM TOWN,Oxford County,2017,4,4,0,0,0,0
SWEDEN TOWN,Oxford County,1980,0,0,0,0,0,0
SWEDEN TOWN,Oxford County,1981,0,0,0,0,0,0
SWEDEN TOWN,Oxford County,1982,0,0,0,0,0,0
SWEDEN TOWN,Oxford County,1983,6,6,0,0,0,0
SWEDEN TOWN,Oxford County,1984,5,5,0,0,0,0
SWEDEN TOWN,Oxford County,1985,2,2,0,0,0,0
SWEDEN TOWN,Oxford County,1986,5,5,0,0,0,0
SWEDEN TOWN,Oxford County,1987,6,6,0,0,0,0
SWEDEN TOWN,Oxford County,1988,13,13,0,0,0,0
SWEDEN TOWN,Oxford County,1989,4,4,0,0,0,0
SWEDEN TOWN,Oxford County,1990,3,3,0,0,0,0
SWEDEN TOWN,Oxford County,1991,3,3,0,0,0,0
SWEDEN TOWN,Oxford County,1992,6,6,0,0,0,0
SWEDEN TOWN,Oxford County,1993,3,3,0,0,0,0
SWEDEN TOWN,Oxford County,1994,6,4,2,2,0,0
SWEDEN TOWN,Oxford County,1995,6,4,2,2,0,0
SWEDEN TOWN,Oxford County,1996,4,4,0,0,0,0
SWEDEN TOWN,Oxford County,1997,4,4,0,0,0,0
SWEDEN TOWN,Oxford County,1998,6,6,0,0,0,0
SWEDEN TOWN,Oxford County,1999,5,5,0,0,0,0
SWEDEN TOWN,Oxford County,2000,4,4,0,0,0,0
SWEDEN TOWN,Oxford County,2001,3,3,0,0,0,0
SWEDEN TOWN,Oxford County,2002,8,8,0,0,0,0
SWEDEN TOWN,Oxford County,2003,6,6,0,0,0,0
SWEDEN TOWN,Oxford County,2004,12,12,0,0,0,0
SWEDEN TOWN,Oxford County,2005,5,5,0,0,0,0
SWEDEN TOWN,Oxford County,2006,7,7,0,0,0,0
SWEDEN TOWN,Oxford County,2007,6,6,0,0,0,0
SWEDEN TOWN,Oxford County,2008,8,8,0,0,0,0
SWEDEN TOWN,Oxford County,2009,2,2,0,0,0,0
SWEDEN TOWN,Oxford County,2010,2,2,0,0,0,0
SWEDEN TOWN,Oxford County,2011,4,4,0,0,0,0
SWEDEN TOWN,Oxford County,2012,3,3,0,0,0,0
SWEDEN TOWN,Oxford County,2013,1,1,0,0,0,0
SWEDEN TOWN,Oxford County,2014,3,3,0,0,0,0
SWEDEN TOWN,Oxford County,2015,1,1,0,0,0,0
SWEDEN TOWN,Oxford County,2016,1,1,0,0,0,0
SWEDEN TOWN,Oxford County,2017,3,3,0,0,0,0
WATERFORD TOWN,Oxford County,1980,0,0,0,0,0,0
WATERFORD TOWN,Oxford County,1981,0,0,0,0,0,0
WATERFORD TOWN,Oxford County,1982,0,0,0,0,0,0
WATERFORD TOWN,Oxford County,1983,0,0,0,0,0,0
WATERFORD TOWN,Oxford County,1984,0,0,0,0,0,0
WATERFORD TOWN,Oxford County,1985,0,0,0,0,0,0
WATERFORD TOWN,Oxford County,1986,0,0,0,0,0,0
WATERFORD TOWN,Oxford County,1987,0,0,0,0,0,0
WATERFORD TOWN,Oxford County,1988,0,0,0,0,0,0
WATERFORD TOWN,Oxford County,1989,0,0,0,0,0,0
WATERFORD TOWN,Oxford County,1990,0,0,0,0,0,0
WATERFORD TOWN,Oxford County,1991,0,0,0,0,0,0
WATERFORD TOWN,Oxford County,1992,0,0,0,0,0,0
WATERFORD TOWN,Oxford County,1993,0,0,0,0,0,0
WATERFORD TOWN,Oxford County,1994,5,5,0,0,0,0
WATERFORD TOWN,Oxford County,1995,7,7,0,0,0,0
WATERFORD TOWN,Oxford County,1996,7,7,0,0,0,0
WATERFORD TOWN,Oxford County,1997,7,7,0,0,0,0
WATERFORD TOWN,Oxford County,1998,13,13,0,0,0,0
WATERFORD TOWN,Oxford County,1999,13,13,0,0,0,0
WATERFORD TOWN,Oxford County,2000,8,8,0,0,0,0
WATERFORD TOWN,Oxford County,2001,9,9,0,0,0,0
WATERFORD TOWN,Oxford County,2002,9,9,0,0,0,0
WATERFORD TOWN,Oxford County,2003,7,7,0,0,0,0
WATERFORD TOWN,Oxford County,2004,7,7,0,0,0,0
WATERFORD TOWN,Oxford County,2005,14,14,0,0,0,0
WATERFORD TOWN,Oxford County,2006,12,12,0,0,0,0
WATERFORD TOWN,Oxford County,2007,9,9,0,0,0,0
WATERFORD TOWN,Oxford County,2008,5,5,0,0,0,0
WATERFORD TOWN,Oxford County,2009,4,4,0,0,0,0
WATERFORD TOWN,Oxford County,2010,5,5,0,0,0,0
WATERFORD TOWN,Oxford County,2011,4,4,0,0,0,0
WATERFORD TOWN,Oxford County,2012,7,7,0,0,0,0
WATERFORD TOWN,Oxford County,2013,9,9,0,0,0,0
WATERFORD TOWN,Oxford County,2014,9,9,0,0,0,0
WATERFORD TOWN,Oxford County,2015,8,8,0,0,0,0
WATERFORD TOWN,Oxford County,2016,9,9,0,0,0,0
WATERFORD TOWN,Oxford County,2017,5,5,0,0,0,0
BATH,Sagadahoc County,1980,5,5,0,0,0,0
BATH,Sagadahoc County,1981,4,4,0,0,0,0
BATH,Sagadahoc County,1982,22,8,14,8,0,6
BATH,Sagadahoc County,1983,20,10,10,10,0,0
BATH,Sagadahoc County,1984,25,9,16,2,7,7
BATH,Sagadahoc County,1985,10,8,2,2,0,0
BATH,Sagadahoc County,1986,14,14,0,0,0,0
BATH,Sagadahoc County,1987,68,55,13,6,7,0
BATH,Sagadahoc County,1988,71,23,48,4,24,20
BATH,Sagadahoc County,1989,14,10,4,4,0,0
BATH,Sagadahoc County,1990,35,9,26,2,0,24
BATH,Sagadahoc County,1991,11,11,0,0,0,0
BATH,Sagadahoc County,1992,15,15,0,0,0,0
BATH,Sagadahoc County,1993,16,16,0,0,0,0
BATH,Sagadahoc County,1994,15,3,12,0,0,12
BATH,Sagadahoc County,1995,19,7,12,0,0,12
BATH,Sagadahoc County,1996,10,10,0,0,0,0
BATH,Sagadahoc County,1997,10,10,0,0,0,0
BATH,Sagadahoc County,1998,7,7,0,0,0,0
BATH,Sagadahoc County,1999,9,5,4,4,0,0
BATH,Sagadahoc County,2000,11,11,0,0,0,0
BATH,Sagadahoc County,2001,3,3,0,0,0,0
BATH,Sagadahoc County,2002,14,10,4,4,0,0
BATH,Sagadahoc County,2003,13,13,0,0,0,0
BATH,Sagadahoc County,2004,7,7,0,0,0,0
BATH,Sagadahoc County,2005,17,15,2,2,0,0
BATH,Sagadahoc County,2006,20,12,8,2,0,6
BATH,Sagadahoc County,2007,5,5,0,0,0,0
BATH,Sagadahoc County,2008,3,3,0,0,0,0
BATH,Sagadahoc County,2009,3,3,0,0,0,0
BATH,Sagadahoc County,2010,4,4,0,0,0,0
BATH,Sagadahoc County,2011,0,0,0,0,0,0
BATH,Sagadahoc County,2012,5,5,0,0,0,0
BATH,Sagadahoc County,2013,2,2,0,0,0,0
BATH,Sagadahoc County,2014,2,2,0,0,0,0
BATH,Sagadahoc County,2015,1,1,0,0,0,0
BATH,Sagadahoc County,2016,18,2,16,0,0,16
BATH,Sagadahoc County,2017,8,8,0,0,0,0
PHIPPSBURG TOWN,Sagadahoc County,1980,13,13,0,0,0,0
PHIPPSBURG TOWN,Sagadahoc County,1981,10,10,0,0,0,0
PHIPPSBURG TOWN,Sagadahoc County,1982,40,40,0,0,0,0
PHIPPSBURG TOWN,Sagadahoc County,1983,16,16,0,0,0,0
PHIPPSBURG TOWN,Sagadahoc County,1984,17,17,0,0,0,0
PHIPPSBURG TOWN,Sagadahoc County,1985,18,18,0,0,0,0
PHIPPSBURG TOWN,Sagadahoc County,1986,25,23,2,2,0,0
PHIPPSBURG TOWN,Sagadahoc County,1987,28,28,0,0,0,0
PHIPPSBURG TOWN,Sagadahoc County,1988,23,23,0,0,0,0
PHIPPSBURG TOWN,Sagadahoc County,1989,37,33,4,4,0,0
PHIPPSBURG TOWN,Sagadahoc County,1990,18,18,0,0,0,0
PHIPPSBURG TOWN,Sagadahoc County,1991,10,10,0,0,0,0
PHIPPSBURG TOWN,Sagadahoc County,1992,13,13,0,0,0,0
PHIPPSBURG TOWN,Sagadahoc County,1993,26,26,0,0,0,0
PHIPPSBURG TOWN,Sagadahoc County,1994,32,32,0,0,0,0
PHIPPSBURG TOWN,Sagadahoc County,1995,29,29,0,0,0,0
PHIPPSBURG TOWN,Sagadahoc County,1996,20,20,0,0,0,0
PHIPPSBURG TOWN,Sagadahoc County,1997,17,17,0,0,0,0
PHIPPSBURG TOWN,Sagadahoc County,1998,17,17,0,0,0,0
PHIPPSBURG TOWN,Sagadahoc County,1999,18,18,0,0,0,0
PHIPPSBURG TOWN,Sagadahoc County,2000,17,17,0,0,0,0
PHIPPSBURG TOWN,Sagadahoc County,2001,18,18,0,0,0,0
PHIPPSBURG TOWN,Sagadahoc County,2002,20,20,0,0,0,0
PHIPPSBURG TOWN,Sagadahoc County,2003,20,20,0,0,0,0
PHIPPSBURG TOWN,Sagadahoc County,2004,20,20,0,0,0,0
PHIPPSBURG TOWN,Sagadahoc County,2005,20,20,0,0,0,0
PHIPPSBURG TOWN,Sagadahoc County,2006,18,18,0,0,0,0
PHIPPSBURG TOWN,Sagadahoc County,2007,15,15,0,0,0,0
PHIPPSBURG TOWN,Sagadahoc County,2008,11,11,0,0,0,0
PHIPPSBURG TOWN,Sagadahoc County,2009,16,16,0,0,0,0
PHIPPSBURG TOWN,Sagadahoc County,2010,16,16,0,0,0,0
PHIPPSBURG TOWN,Sagadahoc County,2011,11,11,0,0,0,0
PHIPPSBURG TOWN,Sagadahoc County,2012,12,12,0,0,0,0
PHIPPSBURG TOWN,Sagadahoc County,2013,8,8,0,0,0,0
PHIPPSBURG TOWN,Sagadahoc County,2014,12,12,0,0,0,0
PHIPPSBURG TOWN,Sagadahoc County,2015,9,9,0,0,0,0
PHIPPSBURG TOWN,Sagadahoc County,2016,10,10,0,0,0,0
PHIPPSBURG TOWN,Sagadahoc County,2017,9,9,0,0,0,0
WEST BATH TOWN,Sagadahoc County,1980,13,13,0,0,0,0
WEST BATH TOWN,Sagadahoc County,1981,8,8,0,0,0,0
WEST BATH TOWN,Sagadahoc County,1982,24,24,0,0,0,0
WEST BATH TOWN,Sagadahoc County,1983,13,13,0,0,0,0
WEST BATH TOWN,Sagadahoc County,1984,41,41,0,0,0,0
WEST BATH TOWN,Sagadahoc County,1985,15,15,0,0,0,0
WEST BATH TOWN,Sagadahoc County,1986,15,15,0,0,0,0
WEST BATH TOWN,Sagadahoc County,1987,31,31,0,0,0,0
WEST BATH TOWN,Sagadahoc County,1988,25,25,0,0,0,0
WEST BATH TOWN,Sagadahoc County,1989,22,22,0,0,0,0
WEST BATH TOWN,Sagadahoc County,1990,35,35,0,0,0,0
WEST BATH TOWN,Sagadahoc County,1991,12,12,0,0,0,0
WEST BATH TOWN,Sagadahoc County,1992,26,26,0,0,0,0
WEST BATH TOWN,Sagadahoc County,1993,26,26,0,0,0,0
WEST BATH TOWN,Sagadahoc County,1994,52,52,0,0,0,0
WEST BATH TOWN,Sagadahoc County,1995,12,12,0,0,0,0
WEST BATH TOWN,Sagadahoc County,1996,7,7,0,0,0,0
WEST BATH TOWN,Sagadahoc County,1997,1,1,0,0,0,0
WEST BATH TOWN,Sagadahoc County,1998,3,3,0,0,0,0
WEST BATH TOWN,Sagadahoc County,1999,2,2,0,0,0,0
WEST BATH TOWN,Sagadahoc County,2000,1,1,0,0,0,0
WEST BATH TOWN,Sagadahoc County,2001,0,0,0,0,0,0
WEST BATH TOWN,Sagadahoc County,2002,0,0,0,0,0,0
WEST BATH TOWN,Sagadahoc County,2003,6,6,0,0,0,0
WEST BATH TOWN,Sagadahoc County,2004,3,3,0,0,0,0
WEST BATH TOWN,Sagadahoc County,2005,9,9,0,0,0,0
WEST BATH TOWN,Sagadahoc County,2006,14,14,0,0,0,0
WEST BATH TOWN,Sagadahoc County,2007,11,11,0,0,0,0
WEST BATH TOWN,Sagadahoc County,2008,10,10,0,0,0,0
WEST BATH TOWN,Sagadahoc County,2009,15,15,0,0,0,0
WEST BATH TOWN,Sagadahoc County,2010,14,14,0,0,0,0
WEST BATH TOWN,Sagadahoc County,2011,5,5,0,0,0,0
WEST BATH TOWN,Sagadahoc County,2012,6,6,0,0,0,0
WEST BATH TOWN,Sagadahoc County,2013,5,5,0,0,0,0
WEST BATH TOWN,Sagadahoc County,2014,7,7,0,0,0,0
WEST BATH TOWN,Sagadahoc County,2015,5,5,0,0,0,0
WEST BATH TOWN,Sagadahoc County,2016,6,6,0,0,0,0
WEST BATH TOWN,Sagadahoc County,2017,6,6,0,0,0,0
BUXTON TOWN,York County,1980,44,44,0,0,0,0
BUXTON TOWN,York County,1981,36,36,0,0,0,0
BUXTON TOWN,York County,1982,28,28,0,0,0,0
BUXTON TOWN,York County,1983,45,45,0,0,0,0
BUXTON TOWN,York County,1984,54,54,0,0,0,0
BUXTON TOWN,York County,1985,39,39,0,0,0,0
BUXTON TOWN,York County,1986,38,36,2,2,0,0
BUXTON TOWN,York County,1987,51,47,4,4,0,0
BUXTON TOWN,York County,1988,48,44,4,4,0,0
BUXTON TOWN,York County,1989,43,43,0,0,0,0
BUXTON TOWN,York County,1990,23,23,0,0,0,0
BUXTON TOWN,York County,1991,18,18,0,0,0,0
BUXTON TOWN,York County,1992,40,40,0,0,0,0
BUXTON TOWN,York County,1993,48,48,0,0,0,0
BUXTON TOWN,York County,1994,37,35,2,2,0,0
BUXTON TOWN,York County,1995,35,35,0,0,0,0
BUXTON TOWN,York County,1996,36,32,4,4,0,0
BUXTON TOWN,York County,1997,45,45,0,0,0,0
BUXTON TOWN,York County,1998,50,50,0,0,0,0
BUXTON TOWN,York County,1999,42,42,0,0,0,0
BUXTON TOWN,York County,2000,42,42,0,0,0,0
BUXTON TOWN,York County,2001,44,42,2,2,0,0
BUXTON TOWN,York County,2002,41,41,0,0,0,0
BUXTON TOWN,York County,2003,82,80,2,2,0,0
BUXTON TOWN,York County,2004,76,68,8,8,0,0
BUXTON TOWN,York County,2005,58,50,8,8,0,0
BUXTON TOWN,York County,2006,33,33,0,0,0,0
BUXTON TOWN,York County,2007,23,23,0,0,0,0
BUXTON TOWN,York County,2008,13,13,0,0,0,0
BUXTON TOWN,York County,2009,16,14,2,2,0,0
BUXTON TOWN,York County,2010,12,12,0,0,0,0
BUXTON TOWN,York County,2011,10,10,0,0,0,0
BUXTON TOWN,York County,2012,15,15,0,0,0,0
BUXTON TOWN,York County,2013,21,21,0,0,0,0
BUXTON TOWN,York County,2014,19,19,0,0,0,0
BUXTON TOWN,York County,2015,24,24,0,0,0,0
BUXTON TOWN,York County,2016,23,23,0,0,0,0
BUXTON TOWN,York County,2017,22,22,0,0,0,0
